བྲས-བུ	resultant level
བྲས-བུའི-སྐྱབས-འགྲོ	resultant taking of safe direction
བྲས-དུས-ཀྱི-རྣམ-ཤེས-ཀྱི-ཡན-ལག	link of loaded consciousness at the time of the result
བྲི-གུང-བཀའ-བརྒྱུད	Drigung Kagyu
བྲུག-པ-བཀའ-བརྒྱུད	Drugpa Kagyu
ཆི-བྱེད	make one dead
ཆི-སྲིད	death existence
དས-པ	no-longer-happening
དོད-ཆགས	longing desire
དོད-ཁམས	 realm of desirable sense objects|plane of sensory desires 
དོད-ལ-འདུན-པ	intentions to experience desirable objects
དོད-པ	compelling wish
དོད-པ-ཉེ-བར-ལེན-པ	obtainer desire
དོད-པའི-ལྷ	Kama
དོད-སྲེད	craving in relation to what is desirable
འདུ	juxtaposition
དུ-བྱེད	affecting variable
དུ-བྱེད-ཀྱི-ཕུང-པོ	aggregate of other affecting variables
དུ-བྱེད-ཀྱི-ཡན-ལག	link of affecting impulses
དུ-ཤེས	 recognition|distinguishing 
དུ-ཤེས-གསུམ	three recognitions
དུ-ཤེས-ཀྱི-ཕུང-པོ	aggregate of distinguishing
དུལ-བ	rules of discipline
དུན-པ	intention
དུས-མ-བྱས	unaffected phenomenon
དུས-བྱས-ཀྱི-ཆོས	affected phenomenon
ཛིན-ཆ	mental hold
ཛིན-པ	cognitively taking an object
ཛིན-སྟངས	way of cognitively taking an object
གག-པ	refute
གལ-བ	mutually exclusive
གོག-པ	stopping
གོག-པའི-བདེན-པ	true stopping
གྲོ-བ	wandering being
གྲོ-བ-རིགས-དྲུག	six realms of existence
གྱོད-པ	regret
གྱུར-བའི-སྡུག-བསྔལ	suffering of change
ཇའ-ལུས	rainbow body
ཇིག-པ	perishing
ཇིག-རྟེན-ལ-གྲགས-པ	commonsense object
ཇིག-རྟེན-ལས-འདས-པ	supramundane
ཇིག-རྟེན-པ	 mundane | perishable based things/aims|householder 
ཇིག-རྟེན-པའ-ཆོས-བརྒྱད	eight transitory things in life
ཇིག-ཚོགས-ལ-ལྟ-བ	deluded outlook toward a transitory network
ཇིགས-པ	dread
ཇིགས-སྲེད	craving because of fear
ཇོག-སྒོམ	stabilizing meditation
ཇུག-པ	cognitive engagement
ཇུག-སེམས	engaged bodhichitta
ཇུག-ཡུལ	involved object
ཁོར-བ	samsara
ཁོར-ལོ-གསུམ	three circles
ཁྲེལ-མེད	no care for how our actions reflect on others
ཁྲེལ-ཡོད	care for how our actions reflect on others
ཁྲུལ-བ	deceptive
ཁྲུལ-བ-ཡེ-ཤེས-སུ-དག-པ	purifying confusion into deep awareness
ཁྲུལ-ཤེས	deceptive cognition
ཁྲུལ-སྣང	deceptive appearance
ཨོད-གསལ	clear light awareness
ཕགས-ལམ	arya pathway mind
ཕགས-པ	arya
ཕངས-པའི-འབྲས-བུའི-ཡན-ལག	resultant links of what has been thrown
ཕེན-བྱེད-ཀྱི-ལས	throwing karma
ཕེན-བྱེད-ཀྱི-ཡན-ལག	causal links that throw
འཕྲང	dangerous gorges
ཕྲིན-ལས	 influencing nature|enlightening influence 
ཕྲོ-བ	distraction
འབད-མེད	effortless
འོད-ལུས	light body
ཨ-ནུ-ཡོ-ག	anuyoga tantra
ཨ-ཏི-ཡོ-ག	 atiyoga tantra|atiyoga 
བག-ཆགས	 karmic habit | karmic latency|karmic constant habit 
བག-ཆགས-ཀྱི-ཀུན-གཞི	alaya for habits
བག-ལ-ཉལ	dormant factor
བག-ལ-ཉལ-གྱི-ཤེས-པ	subliminal cognition
བག-མེད	reckless
བག-ཡོད	caring attitude
བར-ཆད-ཀྱི-ཆོས	impediments
བར-དོ	bardo
བར-དོའི-སྲིད-པ	bardo existence
བཅད-པ	 preclusion|preclude 
བཅད-ཤེས	subsequent cognition
བཅས-པའི-ཁ-ན-མ-ཐོ-བ	 prohibited uncommendable action|prohibited unspeakable action 
བཅོམ	devastate
བཅོམ-ལྡན-འདས	Vanquishing Master Surpassing All
བཅོས-མ	contrived
བཅོས-མེད	uncontrived
བདག	 soul|impossible "soul" 
བདག-འབྲས	dominating result
བདག-འཇུག	self-initiation
བདག-བསྐྱེད	self-generation
བདག-གཞན-བརྗེ-པ	exchanging self and others
བདག-གཞན-མཉམ-བརྗེ	equalizing and exchanging self and others
བདག-གཞན-མཉམ-པ	equalizing self and others
བདག-མེད	lack of an impossible "soul"
བདག-ཉིད	identity-nature
བདག-རྐེན	dominating condition
བདག-ཏུ-སྨྲ-བ	asserting one's identity
བདེ-འགྲོ	better rebirth states
བདེ-འགྲོ-གསུམ	three better rebirth sates
བདེ-བ	 feeling of happiness | happiness|blissful awareness 
བདེ-བ-ཆེན-པོ	greatly blissful awareness
བདེ-བ-ཆེན-པོའི-སྐུ	 corpus of great bliss of a buddha|Corpus of Great Bliss 
བདེ-བར-གཤེགས-པ	Blissfully Gone One
བདེན-འཛིན	grasping for truly established existence
བདེན-པ	being true to one's word
བདེན-པ-གཉིས	two truths
བདེན-པར-གྲུབ-པ	 true findable existence | true unimputed existence|true existence 
བདེན-སྣང	appearance-making of true existence
བདུད	demonic force
བྷ-གའི-དཀྱིལ-འཁོར	mandala of a womb
བཀའ-འགྱུར	Kangyur
བཀའ-བརྒྱུད	Kagyu
བཀའ-བརྒྱུད-པ	Kagyupa
བཀའ-གདམས	Kadam
བཀའ-གདམས-པ	Kadampa
བཀའ-གདམས-པ-དགེ-བཤེས	Kadampa Geshe
བཀའ-མ-རིང-བརྒྱུད	distant lineage of the enlightening words of the Buddha
བླ	 Sublime|life spirit 
བླ-མེད-རྣལ-འབྱོར	anuttarayoga tantra
བློ	 intellect|attitude 
བློ-ཆོས-སུ-འགྲོ-བ	having the mind go toward the Dharma
བློ-བླངས	three-dimensional mandala
བློ-གྲོས	intelligence
བློ-ལྡོག-རྣམ-བཞི	four thoughts that turn the mind toward the Dharma
བློ-རིག	ways of knowing
བློ-སྦྱོང	 lojong|attitude-training 
བློའི-གཞན-སེལ	mental exclusions of something else
བློས-བྱས	intellectually derived
བོན	Bon
བོན-པོ	Bonpo
བྲལ-འབྲས	result that is a state of being parted
བྲལ-བ	parting
བརྡ	label
བརྡར-བཏགས-པའི-ཆོས-དཀོན-མཆོག	nominal Dharma Gem
བརྡར-བཏགས-པའི-དགེ-འདུན-དཀོན-མཆོག	nominal Sangha Gem
བརྡར-བཏགས-པའི-དཀོན-མཆོག	nominal gem
བརྡར-བཏགས-པའི-སངས-རྒྱས-དཀོན-མཆོག	nominal Buddha Gem
བརྣབ-སེམས	covetousness
བརྟེན	something that is supported by something else
བརྟེན-པའི-དཀྱིལ-འཁོར	supported mandala
བརྩེ-བ	loving-kindness
བརྩོན-འགྲུས	 perseverance|joyful perseverance 
བརྟུལ-ཞུགས	tamed behavior
བསམ-གཏན	mental stability
བསམ-གཏན-དང-པོའི-དངོས-གཞི	actual state of the first level of mental constancey
བསམ-གཏན-གྱི-དཀྱིལ-འཁོར	mandala of mental stability
བསམ-པ	 sincerity|motivating mental framework 
བསམ-པའི-ལས	urged impulse
བསྡུ-བ-ལས-འབྱུང-བའི-བསླབས-བྱ	training specified in "The All-Inclusive Text"
བསྡུད-པ-ལས-གྱུར-པའི-གཟུགས	forms of physical phenomena that make up other things by amassing together
བསྡུས-གརབ༹	set theory
བསྒྲིབས-པའི-ལུང-མ-བསྟན	obstructive unspecified phenomenon
བསྒྲུབ-བྱེད-ཀྱི-ཡན-ལག	causal links that actualize
བཤེས-གཉེན-བསྟེན-པ	relating to a spiritual mentor in a healthy manner
བསྐང-གསོ	fulfill and restore ritual
བསྐྱེད-པའི-སྐྱེས-བུ-བྱེད-པའི-འབྲས-བུ	man-made result that is produced
བསྐྱེད-རིམ	generation stage
བསྔོ-བ	dedication prayer
བསྙེན-ཆེན	great approximation retreat
བསྙེན-སྒྲུབ	approximate and actualize oneself as a Buddha-figure
བསོད-ནམས	positive karmic force
བསོད-ནམས-གྱི-ཚོགས	enlightenment-building network of positive force
བསོད-ནམས-ཀྱི-ཚོགས	network of positive force
བཏགས-ཆོས	referent object
བཏགས-དོན	referent thing
བཏགས-ཡོད	imputably knowable phenomenon
བཏང-སྙོམས	 neutral feeling|equanimity 
བཏང-སྙོམས-ཙམ	mere equanimity
བུད-རྙེད-ཐོབ-གསུམ	mature attitudes toward being expelled, finding and attaining
བུམ-དབང	vase empowerment
བྱ-གྲུབ-ཡེ-ཤེས	 awareness, accomplishing|accomplishing deep awareness 
བྱ-རྫོགས-ཀྱི-སྐད-ཅིག-མ	instant that is the final moment or phase when an action is completed
བྱམས-པ	love
བྱམས-པ-ཆེན-པོ	great love
བྱང-ཆུབ	purified state
བྱང-ཆུབ-སེམས-དཔའ	bodhisattva
བྱང-ཆུབ-གྱི-སེམས	bodhichitta
བྱང-གཏེར	Nyingma Northern Treasure Text Lineage
བྱང-སེམས-འཕགས-པ	arya bodhisattva
བྱང-སེམས-སྡོམ-པ	bodhisattva vows
བྱེ-བྲག	individual
བྱེ-བྲག-སྨྲ-བ	Vaibhashika
བྱེད-པ-རྒྱུ-མཐུན-གྱི-འབྲས-བུ	result that corresponds to its cause in one's behavior
བྱེད-པ-པོ	agent
བྱེད-རྒྱུ	acting cause
བྱིན-གྱིས-རླབས	inspiration
བྱིན-གྱིས-རླབས-པའ-ཨི-བཀའ	enlightening words inspired by Buddha
བྱིན-རླབས	resolution
བྱིང-བ	mental dullness
བྱོར-བ	enrichment
བཟོད-པ	patience
ཆད-ཅིང-འཇུག-པའི-ཡིད-བྱེད	restoring attention
ཆད-མེད-རྒྱུད	unbroken continuity
ཆགས-པ	 sticky attachment|attachment 
ཆགས-པ-མེད-པ	detachment
ཆེད-དུ-བརྗོད-པ	special verses
ཆོད	chod
ཆོས	 phenomenon | preventive measures | thing|dharma 
ཆོས-ལམ-དུ-འགྲོ-བ	having the Dharma function as a pathway mind
ཆོས-ཅན	property-possessor
ཆོས-དབྱིངས	sphere of reality
ཆོས-དབྱིངས-ཡེ-ཤེས	deep awareness of reality
ཆོས-ཀྱི-བདག	impossible "soul" of all phenomenon
ཆོས-ཀྱི-བདག-མེད	lack of an impossible "soul" of all phenomena
ཆོས-ཀྱི-སྡོམ-པ-བཞི	four hallmarks of the Dharma
ཆོས-ཀྱི-སྐྱེ-མཆེད	cognitive stimulators that are (all) phenomena
ཆོས-ཀྱི-སྐྱེ-མཆེད-པའི-གཟུགས	forms of physical phenomena included (only) among the cognitive stimulators that are (all) phenomena
ཆོས-ཀྱི-སྤྱན	extrasensory eye of the Dharma
ཆོས-ཉིད	actual nature
ཆོས-སྐུ	Corpus Encompassing Everything
ཆོས-སྐྱོང	Dharma-protector
ཆུ-གཏེར-འཁྲོག-པའི-སྐད	 ocean-rolling voice|ocean-crashing voice 
ཅིག-ཅར-བ	those for whom it happens all at once
ད-ལྟ-བ	present-happening
དད-པ	believing a fact to be true
དག-པའི-སྣང-བ	pure appearance
དག-སྣང-ཟབ-བརྒྱུད	profound lineage of pure visions
དག-ཞིང	pure lands
དལ-བ	respite
དམ-པ	hallowed
དམ-རྫས	bonding substances
དམ-ཚིག	bonding practice
དབང	empowerment
དབང-བཞི-པ	fourth empowerment
དབང-འབྱོར-པའི-གཟུགས	forms of physical phenomena arising from gaining control over the elements
དབང-གི-འབྲས-བུ	commanding results
དབང-པོ	cognitive sensor
དབུ-མ	Madhyamaka
དབུ-མ-རང-རྒྱུད-པ	Svatantrika Madhyamaka
དབུ-མ-ཐལ-འགྱུར-བ	Prasangika Madhyamaka
དབུ-མ-པ	Madhyamika
དབུ-མའི-ལྟ-ཁྲིད	discursive madhyamaka view
དབུས-གནས-ཉིད	even-minded
དབྱངས-ཀྱིས-བསྙད-པ	melodic verses
དབྱེར-མེད	inseparable
དབྱིབས	shape
དབྱིངས	cognitive sphere
དེ-བཞིན-གཤེགས-པ	Thusly Gone One
དེ-བཞིན-ཉིད	accordant nature
དེ-ཁོ-ན-ཉིད-གྱི-ཚངས-སྤྱོད	celibate behavior of reality
དེ-ཁོ-ན-ཉིད	very nature of reality
དེ-ཁོ-ན-ཉིད-མཆོད-པ	offering of the very nature of reality
དེ-ཁོ-ན-ཉིད-ཀྱི-དཀྱིལ-འཁོར	mandala of the very nature of reality, thusness mandala
དེ-ལྟ-བུ-བྱུང-བ	ancient narratives
དེ-མ-ཐག-རཁྱེན	immediately preceding condition
དེ-ཉིད	how things are
དགའ-ལྡན	Pure Land of Joy
དགའ-བ	joyful awareness
དགའ-བ-བཞི	four gradations of joyful awareness
དགའ-བྱེད	make one ecstatic
དགག-བྱ	object to be negated
དགག-པ	negation phenomenon
དགེ-འདུན	Sangha
དགེ-འདུན-ཕལ-ཆེན-པོ	Mahasanghika
དགེ-བ	constructive
དགེ-བའི-བཤེས-གཉེན	spiritual mentor
དགེ-བའི-རྩ-བ	roots of positive force
དགེ-བཤེས	geshe
དགེ-ལུགས	Gelug
དགེ-ལུགས-པ	Gelugpa
དགེ-རྩ	roots of constructive force
དགྲ-བཅོམ-པ	arhat
དཀར-པོ-ཆིག-ཐུབ	singular sufficient white panacea
དཀར-པོའི-ཆོས-བཞི	four types of glowing behaviour
དཀོན-མཆོག-གསུམ	Three Rare and Supreme Gems
དཀོན-མཆོག-གསུམ-ལ-སྐྱབས-སུ-འགྲོ	take safe direction from the Three Gems
དཀྱིལ-འཁོར	mandala
དམིགས-གཏད	focal support
དམིགས-མེད	without a referent aim
དམིགས-མེད-སྙིང-རྗེ	compassion regarding no object
དམིགས-རྐྱེན	focal condition
དམིགས-ཡུལ	focal object
དངོས-འགལ	dichotomy
དངོས-གྲུབ	actual attainment
དངོས-གཞི	 actual state|actual fundamental part 
དངོས-མེད	nonfunctional phenomenon
དངོས-པོ	functional phenomenon
དངོས-པོ-བརྒྱད	eight sets of realizations
དངོས-རྒྱུ	direct cause
དངོས-སུ-བཅད-པ	explicitly preclude
དངོས-སུ-རིག-པ	directly cognize
དངོས-སུ-རྟོགས-པ	explicit apprehension
དངོས-སུ-ཤེས-པ	direct cognition
དོན-རང-མཚན-གྱི-གཞན-སེལ	individually characterized object exclusions of something else
དོན-དམ	deepest
དོན-དམ-བདེན-པ	 deepest truth|deepest true phenomenon 
དོན-དམ-བྱང-སེམས-ཀྱི-དཀྱིལ-འཁོར	mandala of deepest bodhichitta
དོན-དམ-པ	deepest level
དོན-དམ-པའི-བྱང-ཆུབ-གྱི-སེམས	deepest bodhichitta
དོན-དམ-པའི-ཆོས-དཀོན-མཆོག	deepest Dharma Gem
དོན-དམ-པའི-དགེ-འདུན-དཀོན-མཆོག	deepest Sangha Gem
དོན-དམ-པའི-དཀོན-མཆོག	deepest level Precious Gems
དོན-དམ-པའི-སངས-རྒྱས-དཀོན-མཆོག	deepest Buddha Gem
དོན-གཅིག	totally pervasive
དོན-གྱི-འོད-གསལ	actual clear light mind
དོན-ལྡོག	conceptually isolated meaning
དོན-སྤྱི	 meaning/object category | object category | object mental synthesis|meaning category 
དཔའ-བོ	vira
དཔའ-མོ	virini
དཔེའི-འོད-གསལ	model clear light mind
དཔྱད-སྒོམ	discerning meditation
དཔྱོད-པ	subtle discernment
དྲག-པོ	forceful
དྲན-པ	mindfulness
དྲན-པ-ཉེར-བཞག-བཞི	four close placements of mindfulness
དྲང-དོན	 interpretable teaching | scriptures of interpretable meaning|explicit suggestive meaning 
དྲི	smells
དྲི-མ	stain
དྲི-ཟ	those who sustain themselves on fragrances
དྲིན	kindness
དྲིན-དྲན	remembering kindness
དྲིན-གསོ	repaying kindness
དུན-པ-ཚད-མེད	immeasurable intention
དུས	time
དུས-ཀྱི-ཀུན-སློང	contemporaneous motivating aim
དུས-མཐའི-སྐད-ཅིག-མ	instant that is the smallest unit of time
དབ༹ང-བའི-དད-པ	clearheaded belief in a fact
དབ༹ངས	lucidity
ཛག-བདེ	bliss of orgasmic emission
གའུ-མ	amulet box tradition
གང-ཟག	person
གང-ཟག-ཀྱི-བདག	impossible "soul" of a person
གང-ཟག-ཀྱི-བདག-མེད	lack of an impossible soul of a person
གཅེས-ཞིང-ཕམ-པའི-བྱམས-པ	cherishing concerned love
གཅིག	monad
གཅོད	cutting-off (tradition)
གདགས-གཞི	basis for labeling
གདམས-ངག	guideline instructions
གླེང-བཞི	ethical narratives
གློ-བུར-གྱི-དྲི-མ	fleeting stain
གནད	key points
གནས-ཆ	mental abiding
གནས-ལུགས	abiding nature
གནས-སྐབས-ཀྱི-སྐྱབས-གནས	provisional source of safe direction
གནོད-སེམས	ill-will
གཉེན-པོ-བཞི	four opponent forces
གཉིད	sleepiness
གཉིས-མེད	nondual
གཉིས-མེད-རྒྱུད	nondual tantra
གཉིས-སྣང	 dualistic appearances|dualistic appearance-making 
གཉིས-ཚོགས-ཀྱི-སྒོ-ནས-བསྙེན-པར-རྫོགས-པ	dual sangha ordination
གཉུག-མ	primordial state
གཉུག-སེམས	primordial mind
གོ-ཆའི-བརྩོན-འགྲུས	armor-like joyful perseverance
གོལ-ས	deviation
གོང-མའི-སྤྱི	vertical mental synthesis
གྲུབ-མཐའ	tenet system
གྲུབ-ཐོབ-ཆེན-པོ	greatly accomplished tantric practitioner
གསལ	clarity
གསལ-བ	 vividness|in focus 
གསལ-སྣང-ཟུང-འཇུག	clarity and appearances, unified pair of
གསང-བ	enigmatic
གསང-བའི-དཀྱིལ-འཁོར	secret mandala
གསང-དབང	secret empowerment
གསང-མཆོད	hidden offering
གསང-སྒྲུབ	Hiddenly Actualized
གསང-སྔགས	hidden mantra
གསར	fresh
གསར-མ	Sarma
གསེར-སྐྱེམས	golden libation
གསོལ-འདེབས	requests
གསོས-འདེབས	 arouse|activate 
གསུང-རབ	scriptural teaching
གསུང-རབ-ཡན-ལག-བཅུ-གཉིས	twelve scriptural categories
གསུངས-གིས-བྱིན-གྱིས-རླབས-པའི-བཀ	enlightening words inspired by Buddha's speech
གཏད-པ-བཞི	four trusting acceptances
གཏན-ལ-དབབ-པ	ascertainment
གཏན-ལ-ཕབ-པ	decisive explications
གཏེར-མ	treasure text
གཏེར-མ-ཉེ-བརྒྱུད	near lineage of treasure texts
གཏེར-སྟོན	revealer of treasure texts
གཏི-མུག	naivety
གཏི-མུག-མེད-པ	lack of naivety
གཏོར-མ	torma
གཙོ-བོ	primal matter
གཙོ-སེམས	principal awareness
གཙུག-ཏོར	crown-protrusion
གཏུམ-མོ	tummo
གུས-པ	appreciation
གྱ-ནོམ-པ	superior state
གཞལ-བྱ	comprehensible phenomena
གཞལ-བྱའི-གནས-གསུམ	three types of comprehensible phenomena
གཞལ-ཡས-ཁང	immeasurably magnificent palace
གཞན-གཅེས-པར-འཛིན-པ	cherishing others
གཞན-དབང	dependent phenomenon
གཞན-སེལ	exclusions of something else
གཞན-སེམས-ཤེས-པའི-མངོན-ཤེས	advanced awareness of knowing other's minds
གཞན-སྟོང	other-voidness
གཞི	basis level
གཞི-ལྡོག	bases for conceptually isolated items
གཞི-མཐུན	common locus
གཞི-ཤེས	basis or fundamental realized awareness
གཞི-སྣང-གི-རིག-པ	appearance-making basis rigpa
གཞིའི-རིག-པ	basis rigpa
གཟུགས	 sights|forms of physical phenomena 
གཟུགས-བསྙན	mental derivative
གཟུགས-ཁམས	 realm of ethereal forms|plane of ethereal forms 
གཟུགས-ཀྱི-ཕུང-པོ	aggregate of forms of physical phenomena
གཟུགས-ཀྱི-སྐྱེ-མཆེད	cognitive stimulators that are sights
གཟུགས-མེད-ཁམས	plane of formless beings
གཟུགས-སྐུ	Corpus of Forms
གཟུང-འཛིན	consciousness that takes objects and objects taken by consciousness
ཀ-དག	primal purity
ཀར-མ-བཀའ-བརྒྱུད	Karma Kagyu
ཁ-འདོན	recitation practice
ཁ-ན-མ-ཐོ-བ	unspeakable action
ཁམས	plane
ཁམས-བཅུ-བརྒྱད	eighteen sources
ཁམས-དེ-བཞིན-སྙིང-པོ	Buddha-nature factors
ཁམས-གསུམ	three planes of samsaric existence
ཁོང-ཁྲོ	anger
ཁྲིད	discourse
ཁྲོ-བོ	forceful deity
ཁྱབ	pervasive
ཁྱབ-པ	pervasion
ཁྱབ-པའི-དམིགས-པ	pervasive object of focus
ཁྱབ-པར-འདུ-བྱེད-ཀྱི-སྡུག-བསྔལ	all-pervasively affecting suffering
ཀློང	cognitive open space
ཀློང-སྡེ	 open space division|longdey 
ཀུན-འབྱུང	origin
ཀུན-འབྱུང-བདེན-པ	true origin
ཀུན-འགྲོ	ever-functioning subsidiary awareness
ཀུན-འགྲོའི-རྒྱུ	driving cause
ཀུན-བཏགས	totally conceptional phenomena
ཀུན-བཏགས-པའི-གཟུགས	totally imaginary forms of physical phenomena
ཀུན-ད	jasmine flower drops
ཀུན-དཀྲིས-བཞི	four binding factors
ཀུན-གཞི	basis for all
ཀུན-གཞི-རྣམ-ཤེས	all-encompassing foundation consciousness
ཀུན-གཞི-ཡེ-ཤེས	deep awareness alaya
ཀུན-མཁྱེན	omniscient awareness
ཀུན-མཁྱེན-ཡིག-ཆ	Kunkyen textbooks
ཀུན-རྫོབ	superficial
ཀུན-རྫོབ-བདེན-པ	 superficial truth|superficial true phenomenon 
ཀུན-རྫོབ-བྱང-སེམས-ཀྱི-དཀྱིལ-ཁོར	mandala of relative bodhichitta
ཀུན-རྫོབ-གྱི-བྱང-ཆུབ-གྱི-སེམས	conventional bodhichitta
ཀུན-རྫོབ-པའི-ཆོས-དཀོན-མཆོག	apparent Dharma Gem
ཀུན-རྫོབ-པའི-དགེ-འདུན-དཀོན-མཆོག	apparent Sangha Gem
ཀུན-རྫོབ-པའི-དཀོན-མཆོག	apparent level Precious Gems
ཀུན-རྫོབ-པའི-སངས-རྒྱས-དཀོན-མཆོག	apparent Buddha Gem
ཀུན-ཤེས-རྣམ-ཤེས	specific-awareness alaya
ཀུན-སློང	motivating aim
ལམ	 pathway mind|pathway level 
ལམ-འཁྲུལ-བ-སེལ-བ	having the pathway minds eliminate confusion
ལམ-འབྲས	lamdray
ལམ-བདེན	true pathway mind
ལམ-གཙོ-རྣམ-གསུམ	three principal pathway minds
ལམ-ལྔ	five bodhisattva pathway minds
ལམ-རིམ	lam-rim
ལམ-རིམ-པ	those who progress through stages
ལམ-ཤེས	pathway realized awareness
ལས	 karma|impulsive behavior 
ལས-འབྲས	behavioral cause and effect
ལས-ཀྱི-ཕྱག-རྒྱ	sealing partner for physical actions
ལས-ཀྱི-རླུང	winds of karma
ལས-རུང	serviceability retreat
ལྕི-བའི-ཆོས	eight weighty restrictions
ལྡན-མིན-འདུ-བྱེད	noncongruent affecting variable
ལྡན-པའི-འདུ-བྱེད	congruent affecting variables
ལྡོག-པ	conceptually isolated item
ལེན-པ	obtainer
ལྷ	divine being
ལྷ-མ-ཡིན	would-be divine
ལྷ-ཡུལ	divine realm
ལྷའི-མིག-གི-མངོན-ཤེས	advanced awareness of the divine eye
ལྷའི-རྣ-བའི-མངོན-ཤེས	advanced awareness of the divine ear
ལྷའི-སྤྱན	extrasensory divine eye
ལྷག-བཅས-ཀྱི-མྱ-ངན-འདས	nirvana with residue
ལྷག-བསམ	 exceptional sincerity|exceptional resolve 
ལྷག-གེ	 vividly and distinctly|distinctly 
ལྷག-མེད-མྱ-ངན-འདས	nirvana without residue
ལྷག-མཐོང	exceptionally perceptive state of mind
ལྷན-ཅིག-འབྱུང-བའི-རྒྱུ	 simultaneously arising causes|simultaneously arising cause 
ལྷན-ཅིག-བྱེད-པའི-རྐྱེན	simultaneously acting condition
ལྷན-ཅིག-སྐྱེས-སྦྱོར	simultaneously arising as merged
ལྷན-སྐྱེས	 co-arising | simultaneously arising|automatically arising 
ལྷན-སྐྱེས-བདེ-བ-ཆེན-པོ	simultaneously arising greatly blissful awareness
ལྷོ-གཏེར	Nyingma Southern Treasure Text Lineage
ལྷུན-གྲུབ	spontaneously establishing appearances
ལྷུན-གྲུབ-སྦུབས-ཀྱི-རིག-པ	rigpa of all-embracing spontaneous presence
ལྐོག-ན-མོ	hidden
ལྐོག-གྱུར	obscure phenomenon
ལྔ-ལྡན	possessing five tradition
ལོ-གསུམ-ཕྱོགས-གསུམ	three years and three phases of the moon
ལོ-ཙ-བ	eye-opening
ལོག-འཚོ	wrong livelihood
ལོག-ལྟ	 distorted outlook|distorted antagonistic thinking 
ལོག-ཤེས	distorted cognition
ལོངས-སྤྱོད-རྫོགས-པའི-སྐུ	Corpus of Full Use
ལྟ-བ	 view|outlook 
ལྟ-བ-བཀའ-བཏགས-གྱི-ཕྱག-རྒྱ-བཞི	four sealing points for labeling an outlook as being based on enlightening words
ལྟ-བ-མཆོག-ཏུ-འཛིན-པ	holding a deluded outlook as supreme
ལྟ-བ-ངན-པ-དྲུག-ཅུ-རེ-གཉིས	sixty-two wrong views
ལྟ-བ-ཉེ-བར-ལེན-པ	obtainer deluded outlook
ལྟ-བ-ཉོན-མོངས-ཅན	deluded outlook
ལྟ-མིན-ཉོན-མོངས	disturbing emotions without an outlook on life
ལྟ-སྒོམ-སྤྱོད-གསུམ	view of reality, way of meditating, and way of behaving
ལུགས-འབྱུང	progressive sequence
ལུགས-ལྡོག	reversal sequence
ལུང	oral transmission
ལུང-མ-བསྟན	unspecified phenomenon
ལུང-བསྟན-པ	revelatory accounts
ལུང-གི-རྗེས-འབྲང	Follower of Scripture
ལུས-ཕྲ-མོ	subtle body
ལུས-ཤིན-ཏུ-ཕྲ-མོ	subtlest body
ལུས-ཅན	embodied being
ལུས-དཀྱིལ	body mandala
ལུས-ཀྱི-རྣམ-ཤེས	body consciousness
མ-འོང-པ	not-yet-happening
མ-བཅོས-པའི-སེམས	noncontriving mind
མ-བསྒྲིབས-པའི-ལུང-མ-བསྟན	nonobstructive unspecified phenomenon
མ-དག	unpurified
མ-དག-པའི-སྣང-བ	impure appearance
མ-ཧ-ཡོ-ག	mahayoga
མ-རྒྱུད	mother tantra
མ-རིག-ཀུན-བརྟགས	doctrinally based unawareness
མ-རིག-པ	unawareness
མ-རིག-པའི-ཡན-ལག	link of unawareness
མ-རིགས-ལྷན-སྐྱེས	automatically arising unawareness
མ-ཡིན-དགག	implicative negation phenomenon
མ-ཡིན-པ-ལས-ལོག-པ	nothing-other-than
མན-ངག	quintessence teachings
མན-ངག-སྡེ	quintessence teachings division
མན-ངག-ལས-འབྱུང-བའི-བསླབས-བྱ	training specified from guideline instructions
མར-ཤེས	mother-awareness
མཆེད	light diffusion
མཆོད-པ	 offering ritual|offering 
མཆོད-རྟེན	stupa
མདོ	sutra
མདོ-སྡེ-སྤྱོད-པའི-དབུ-མ-རང-རྒྱུད-པ	Sautrantika-Svatantrika
མདོ-སྡེ-པ	Sautrantika
མདོའི-གསང-ལམ	hidden path of sutra
མདོའི-ཕྱག-ཆེན	sutra mahamudra
མདུན-བསྐྱེད	front-generation
མཛད-པ	enlightening deeds
མེ-ལོང-ལྟ-བུའི-ཡེ-ཤེས	mirror-like deep awareness
མེད-དགག	nonimplicative negation phenomenon
མེད-དགག-གི-གཞན-སེལ	nonimplicative negation exclusions of something else
མེད-པ	nonexistents
མེད-སྣང	 appearances of non-true existence|appearance-making of non-true existence 
མགོན-པོ	guardian
མི-འགྱུར-རྡོ-རྗེའི-སྐུ	Immutable Vajra Corpus
མི-འགྱུར-བའི-བདེ-བ	unchanging bliss
མི-བདེ-བ	unhappiness
མི-བསླུ-བ	nonfallacious
མི-དགེ-བ	destructive
མི-གཡོ-བ-གསུམ	three immovables
མི-གནས-པའི-མྱ-ངན-འདས	nonabiding nirvana
མི-རྟག-པ	 nonstatic phenomenon|nonstaticness 
མི-རྟག-པ-ཕྲ-མོ	subtle impermanence
མི-རྟག-པ-རགས-པ	gross impermanence
མི-ཤེས-སྒྲིབ	obscurations of not knowing
མི-སློབ-ལམ	pathway mind needing no further training
མི-སྲིད-པ	invalid phenomenon
མིག-གི-སྤྱོད-ཡུལ-དུ-འགྱུར-བའི-གཟུགས	forms of physical phenomena that can become objects of experience of the eyes
མིང	name
མིང-འདོགས-པ	mental labeling
མིང-དང-གཟུགས-ཀྱི-ཡན-ལག	link of nameable mental faculties with or without gross form
མཁའ-འགྲོ	 daka|celestial maiden whose movements are unimpeded by ignorance 
མཁའ-འགྲོ-མ	dakini
མཁས-པའི-དམིགས-པ	object of focus with knowledge
མངོན-འདོད-ཀྱི-དད-པ	belief in a fact with an aspiration
མངོན-བྱང-གི-སྐུ	 corpus of manifest enlightenment of a buddha|Corpus of Manifest Enlightenment 
མངོན-གྱུར	obvious phenomenon
མངོན-པར-གྲུབ-པའི-འབྲས-བུའི-ཡན-ལག	resultant links of what is actualized
མངོན-པར-སྐབས-ཡོད-པའི-གཟུགས	forms of physical phenomena existing in actual situations
མངོན-རྟོགས	antecedent practice for realization
མངོན-ཤེས	advanced awareness
མངོན-སུམ	 straightforward cognition|bare cognition 
མངོན-སུམ-ཚད-མ	 valid straightforward|valid bare cognition 
མཉམ-བཞག	total absorption
མཉམ-ཉིད	equality
མཉམ-ཉིད-ཡེ-ཤེས	equalizing deep awareness
མོ	prognostication
མོས-པ	firm conviction
མཐར-འཛིན-པའི-ལྟ-བ	extreme outlook
མཐར-ཐུག	ultimate level
མཐར-ཐུག-ཐེག-པ	ultimate vehicles of mind
མཐར-ཐུག-གི-སྐྱབས-གནས	ultimate source of safe direction
མཐོ-རིས	superior rebirth state
མཐོང-ལམ	seeing pathway mind
མཐུན-འགྱུར	helping passages
མཚམས-མེད-ལྔ	five heinous crimes
མཚམས-སྦྱོར	connecting passages
མཚན-བཟང-པོ-གསུམ-ཅུ-རྩ-གཉིས	thirty-two excellent signs
མཚན-བཅས	with signs
མཚན-མེད	without signs
མཚན-ཉིད	defining characteristic mark
མཚན-ཞབས	Master Debate Partner
མཚོན-བྱེད-ཀྱི-ཆོས	exemplifying topic
མཚུངས-ལྡན	congruent
མཚུངས-ལྡན-ལྔ	 sharing five congruent factors|five congruent features 
མཚུངས-ལྡན-མེད-པ	noncongruent
མཚུངས-ལྡན-གྱི-རྒྱུ	congruent cause
མུ-བཞི	tetralemma
མུ-གསུམ	trilemma
མུ-སྟེགས-པ	non-Buddhist extremist
མྱ-ངན-འདས	nirvana
མྱོང-བ-རྒྱུ-མཐུན-གྱི-འབྲས-བུ	result that corresponds to its cause in one's experience
ནག-པོའི-ཆོས-བཞི	four types of murky behaviour
ནང-གི-དཀྱིལ-འཁོར	inner mandala
ནང-མཆོད	inner offering
ངན-འགྲོ	worse rebirth states
ངན-འགྲོ-གསུམ	three worse rebirth states
ངང-གིས-གནས	naturally settle down
ངར	sharp focus
ངར-འཛིན	 self-preoccupation|preoccupation with "me" 
ངེས-འབྱིན-པ	means for definite removals
ངེས-འབྱུང	 renunciation|definite emergence 
ངེས-དོན	 implicit suggested meaning|definitive teaching 
ངེས-པ	decisively determine
ངོ-འཕྲོད	meet face to face
ངོ-བོ	essential nature
ངོ-བོ-གཅིག	same essential nature
ངོ-བོ-ཉིད-ཆོས-སྐུ	Svabhava-dharmakaya
ངོ-བོ-ཉིད-སྐུ	 corpus of essential nature of a buddha|Corpus of Essential Nature 
ངོ-བོའི-རིག-པ	essence rigpa
ངོ-སྤྲོད	get to know face to face
ངོ-ཚ-མེད-པ	 no sense of moral self-dignity|no moral self-dignity 
ངོ-ཚ-ཤེས-པ	moral self-dignity
ངོས-བཟུང	identifiable
ནུས-པ	potentials
ཉམས	boon experience
ཉན-ཐོས	shravaka
ཉན-ཐོས-འཕགས-པ	arya shravaka
ཉན-ཐོས-དགྲ-བཅོམ	shravaka arhat
ཉེ-བརྒྱུད	near lineage
ཉེ-ཉོན	auxiliary disturbing emotions
ཉེར-ལེན-གྱི-ཕུང-པོ	obtaining aggregates
ཉེར-ལེན-གྱི-རྒྱུ	obtaining cause
ཉེར-ལེན-གྱི-ཡན-ལག	link of an obtainer
ཉེར-ཐོབ	threshold
ཉེས-བྱས	 faulty behaviour (46 types of)|faulty actions 
ཉོན-མོངས	disturbing emotion or attitude
ཉོན-མོངས-ཀུན-བརྟགས	doctrinally based disturbed emotions and attitudes
ཉོན-མོངས-ལྷན-སྐྱེས	automatically arising disturbing emotions and attitudes
ཉོན-མོངས-ཀྱི-མིང-བཏགས-པ	nominal disturbing attitude
ཉོན-མོངས-པ-རྣམ-པར-སྦྱོང-བའི-དམིགས-པ	object of focus for cleansing oneself of disturbing emotions and attitudes
ཉོན-སྒྲིབ	emotional obscurations
ཉོན-ཡིད	deluded awareness
ཕ-རྒྱུད	father tantra
ཕ-རོལ-ཏུ-ཕྱིན-པ	far-reaching attitude
ཕའི-དགེ-འདུན-རྐྱང-པའི-བསྙེན-པར-རྫོགས-པ	single bhikshu sangha ordination
ཕན-སེམས	benevolence
ཕོ-བ	phowa
ཕྲག-དོག	jealousy
ཕུང-པོ	 aggregate factors of experience | five aggregate factors of experience|aggregate 
ཕུང-པོ-ལྔ	five aggregate factors
ཕྱག-རྫོགས-ཟུང-འཇུག	unified pair of mahamudra and dzogchen
ཕྱག-རྒྱ	 sealing partner|mudra 
ཕྱག-རྒྱ-ཆེན-པོ	mahamudra
ཕྱི-དོན	external phenomenon
ཕྱིའི-དཀྱིལ-འཁོར	outer mandala
ཕྱིའི-མཆོད-པ	outer offerings
ཕྱིར-འཆོས	expiation ritual
རབ-སྐྱེས	strong producer
རབ-ཏུ-འབྱུང-བ	homeless renunciate
རང-བཅེས-པར-འཛིན-པ	self-cherishing
རང-བབས	state that mind naturally falls to
རང-བབས-གཉུག-མའི-དྲན-པ	primordial mindfulness of having dropped down to the natural state
རང-བྱུང-ཡེ-ཤེས	self-arising deep awareness
རང-བཞིན	 self-nature|functional nature 
རང-བཞིན-དབྱེར-མེད	natural inseparability
རང-བཞིན-གནས-རིགས	naturally abiding family-traits
རང-བཞིན-གྱི-དྲི-མ	self-established stain
རང-བཞིན-གྱི-ཁ-ན-མ-ཐོ-བ	 naturally unspeakable action|naturally uncommendable action 
རང-བཞིན-གྱི-མྱ-ངན-འདས	natural nirvana
རང-བཞིན-གྱིས-གྲུབ-པ	existence established by self-nature
རང-གི-མཚན-ཉིད	individual defining characteristic mark
རང-གི-ངོ-བོ	essential nature as itself
རང-གིས	reflexively
རང-གྲོལ	 automatic liberation|automatically releases itself in its own place 
རང-ལྡོག	items conceptually isolated by themselves
རང-མཚན	objective entities
རང-ངོ	own face
རང-ངོ-ཤེས-པ	awareness of its own face
རང-རྒྱལ	pratyekabuddha
རང-རྒྱལ-འཕགས-པ	arya pratyekabuddha
རང-རྒྱལ-དགྲ-བཅོམ	pratyekabuddha arhat
རང-རྒྱུད-པ	Svatantrika
རང-རིག	reflexive awareness
རང-རིག-ཡེས-ཤེས	reflexive deep awareness
རང-རྐྱ-ཐུབ-པའི-རྫས-ཡོད	 self-sufficiently knowable phenomenon|self-sufficiently knowable 
རང-སར-ཞི	naturally still in their own place
རང-སྣང	reflexive appearance
རང-སྟོང	self-voidness
རས-བྲིས-ཀྱི-དཀྱིལ-འཁོར	cloth mandala
རྡོ-རྗེ-དབྱུག-པ	having a vajra stick
རྡོ-རྗེ-གསུམ	three diamond-strong convictions
རྡོ-རྗེ-ལུས	vajra-body
རྡོ-རྗེ-སྐྱིལ-ཀྲུང	vajra posture
རྡོ-རྗེ-སློབ-དཔོན	tantric master
རྡོ-རྗེ-ཐེག-པ	Vajrayana
རྡོ-རྗེ-ཡེ-ཤེས-ཀྱི-དབང	vajra deep awareness empowerment
རྡོ-རྗེ-ཨི-སྐུ	 vajra corpus of a buddha|Vajra Corpus 
རྡུལ-ཕྲན-གྱི-དཀྱིལ-འཁོར	powdered sand mandala
རྫས	natal source
རྫས-སུ-གྲུབ-པ	substantially established existence
རྫོགས-བྱེད-ཀྱི-ལས	completing karma
རྫོགས-ཆེན	dzogchen
རྫོགས-པ	exhaust and finish
རྫོགས-རིམ	complete stage
རྫུ-འཕྲུལ	extraphysical emanations
རྫུ-འཕྲུལ-གྱི-མངོན-ཤེས	advanced awareness for extraphysical emanation
རེག-བྱ	physical sensations
རེག-པ	contacting awareness
རེག-པའི-ཡན-ལག	link of contacting awareness
རྒ-ཤི	aging and dying
རྒ-ཤིའི-ཡན-ལག	link of aging and dying
རྒོད-པ	flightiness of mind
རྒྱལ-བ	 Triumphant One|The Triumphant One 
རྒྱལ-སྲས	spiritual offspring of the Triumphant Ones
རྒྱན	filigree
རྒྱས-འགྱུར-གྱི-རིགས	evolving family-traits
རྒྱས-པ	stimulating others' good qualities
རྒྱུ	cause
རྒྱུ-འབྲས-མན-ངག-བདུན	seven-part cause and effect quintessence teaching for developing bodhichitta
རྒྱུ-དུས-ཀྱི-རྣམ-ཤེས-ཀྱི-ཡན-ལག	link of loaded consciousness at the time of the cause
རྒྱུ-མཐུན-གྱི-འབྲས-བུ	result that corresponds to its cause
རྒྱུའི-ཀུན-སློང	causal motivating aim
རྒྱུའི-རྐྱེན	causal conditions
རྒྱུའི-སྐྱབས-འགྲོ	causal taking of safe direction
རྒྱུད	tantra
རྒྱུན	stream of continuity
རི-བོ-རལ-བའི-སྐད	mountain-cracking voice
རིག-གནས-ལྔ	five major fields of knowledge
རིག-མ	pure awareness partner
རིག-པ	pure awareness
རིགས	 family-trait|caste 
རིགས-དྲའི-རྒྱུ	similar family cause
རིགས-ངེས-པའི-བྱང-སེམས	bodhisattva arhats of definite lineage
རིགས-པ	appropriate means
རིགས-པ-བཞི	four axioms
རིགས-པའི-རྗེས-འབྲང	Follower of Logic
རིགས-སྤྱི	kind mental synthesis
རིང-བརྒྱུད	distant lineage
རིས-མཐུན	slant
རྗེ-བཙུན	ennobling, impeccable
རྗེས-དཔག	inferential cognition
རྗེས-དཔག-ཚད-མ	valid inferential cognition
རྗེས-སྣང	subsequent permission
རྗེས-སུ-གནང-བའི-གསུང	permitted words
རྗེས-ཐོབ	 subsequent attainment phase|subsequent attainment 
རྐྱང-མ	left energy-channel
རྐྱེན	condition
རླུང	energy-wind
རླུང-ཕྲ-མོ	subtle energy-winds
རྨད-དུ-བྱུང-བ	fabulous accounts
རྨི-ལམ-གྱི-གཟུགས	dream body
རྨོངས-བྱེད	make one stupefied
རྨོངས-ཆ	dumbfoundedness
རྨོངས-པ	bewilderment
རྨུགས-པ	foggy-mindedness
རྣལ-འབྱོར-བཞི	four yogas
རྣལ-འབྱོར-སྤྱོད-པ	Yogachara
རྣལ-འབྱོར-སྤྱོད-པའི-དབུ-མ-རང-རྒྱུད-པ	Yogachara-Svatantrika
རྣལ-འབྱོར-མ	yogini
རྣམ-འཕྲུལ	miraculous emanations
རྣམ-གཡེང	mental wandering
རྣམ-གྲངས-མ-ཡིན-པའི-དོན-དམ	nondenumerable ultimate phenomenon
རྣམ-གྲངས-པའི-དོན-དམ	denumerable ultimate phenomenon
རྣམ-མཁྱེན	omniscient realized awareness
རྣམ-པ	mental aspect
རྣམ-པར-རིག-བྱེད-མ-ཡིན-པའི-གཟུགས	nonrevealing form
རྣམ-པར-རིག-བྱེད-ཀྱི-གཟུགས	revealing form
རྣམ-རྟོག	 discursive thought|conceptual thinking 
རྣམ-ཤེས	 primary consciousness | specific awareness|consciousness 
རྣམ-ཤེས-ཡེ-ཤེས	specific and deep awareness
རྣམ-ཤེས-ཀྱི-ཕུང-པོ	aggregate of primary consciousnesses
རྣམ-ཤེས-ཀྱི-ཡན-ལག	link of loaded consciousness
རྣམ-སྨིན-གྱི-འབྲས-བུ	ripened result
རྣམ-སྨིན-གྱི-རྒྱུ	ripening cause
རྙིང-མ	 Old Translation|Nyingma 
རྙིང-མ-པ	Nyingmapa
རོ	tastes
རོ-གཅིག	single taste
རོ-མ	right energy-channel
རོལ-པ	play
རྟག-ལྟ	eternalism
རྟག-པ	 static phenomena|staticness 
རྟགས	line of reasoning
རྟགས-རིག	ways of logical proof
རྟེན	 support|something that supports something else 
རྟེན-འབྲེལ	dependent arising tradition
རྟེན-འབྲེལ-ཡན-ལག-བཅུ-གཉིས	twelve links of dependent arising
རྟེན-ཅིང-འབྲེལ-བར-འབྱུང-བ	dependent arising
རྟེན-པའི-དཀྱིལ-འཁོར	supporting mandala
རྟོག-བཅས	conceptual
རྟོག-མེད-ཤེས-པ	nonconceptual cognition
རྟོག-པ	 conceptual cognition | gross detection|concept 
རྟོགས-གྲོལ-དུས-མཉམ	simultaneous realization and liberation
རྟོགས-པ	 realization | stable realization|apprehend 
རྟོགས-པར-བརྗོད-པ	illustrative accounts
རྩ	energy-channel
རྩ-དབུ-མ	central energy-channel
རྩ-འཁོར	energy-node
རྩ-བའི-བླ-མ	root guru
རྩ-ལྟུང	root downfall
རྩ-ཉོན	root disturbing emotions and attitudes
རྩལ	display
རྩལ-གྱི-རིག-པ	effulgent rigpa
རྩེ-གཅིག	single-pointedness
རྩོལ-བཅས	labored
རྩོལ-མེད	unlabored
རྩོལ-མེད-བྱང-སེམས	unlabored bodhichitta
ས	 ten bhumi levels of minds|bhumi-mind 
ས-བཅུ	ten levels of highly realized minds
ས-བོན	 karmic tendency | leaving a legacy (planting "seeds")|karmic legacy 
ས-བོན-གྱི-ངོ-བོར-གྱུར-བ	karmic force that has taken on the essential nature of a karmic tendency
སངས-རྒྱས	 clear-minded and fully evolved | totally clear-minded and fully evolved|Buddha 
སངས-རྒྱས-ཀྱི-བཀའ	Buddha's enlightening speech
སངས-རྒྱས-ཀྱི-བཀའ-གསུམ	three divisions of Buddha's enlightening speech
སངས-རྒྱས-ཀྱི-རིགས	Buddha-nature
སངས-རྒྱས-ཀྱི-སྤྱན	extrasensory eye of a Buddha
སངས-རྒྱས-ཀྱི-ཞིང	Buddha-field
སར-མ	New Translation
སྦོམ-པོ	thick actions
སྦྱངས-པའི-ཡོན-ཏན	twelve characteristics of observed practice
སྦྱིན-པ	generosity
སྦྱིན-སྲེག	fire-puja
སྦྱོར-བ-བཞི	 four sets of applied realizations|four actions 
སྦྱོར-བཅས-དབྱེར-མེད	joined inseparability
སྦྱོར-ལམ	applying pathway mind
སྡིག-པ	negative karmic force
སྡོམ-པ	vow
སྡུག-བསྔལ-བདེན-པ	true suffering
སྡུག-བསྔལ-བ	miserable phenomena
སྡུག-བསྔལ-གྱི-སྡུག-བསྣལ	suffering of suffering
སེལ-བ	exclude
སེམས	 sem|mind 
སེམས-ཕྲ-མོ	subtle mind
སེམས-ཤིན-ཏུ-ཕྲ-མོ	subtlest mind
སེམས-བྱུང	subsidiary awareness
སེམས-ཅན	limited being
སེམས-དོན	mind's deepest point
སེམས-གནས-དགུ	nine stages of settling the mind
སེམས-ཉིད	 mind-itself|deepest nature of the mind 
སེམས-པ	mental urge
སེམས-པའི-ལས	urging impulse
སེམས-རྒྱུད	mental continuum
སེམས-སྡེ	 semdey|mind division 
སེམས-ཙམ	mind-only
སེམས-ཙམ-པ	Chittamatra
སྒོམ	meditation
སྒོམ-ལམ	accustoming pathway mind
སྒོམ-མེད	no further meditation
སྒྲ	sound
སྒྲ-སྤྱི	audio category
སྒྲིབ	obscuration
སྒྲིབ-པ-ལྔ	five obscurations
སྒྲོ-འདོགས	interpolation
སྒྲུབ-པ	 actualize | affirmation phenomenon|accomplishment 
སྒྲུབ-ཐབས	sadhana
སྒྲུབས-པ	means for actualizations
སྒྱུ-ལུས	illusory body
ཤའི-སྤྱན	extrasensory flesh eye
ཤཀྱའི-ཐུབ-པ	Shakyamuni
ཤར-བ	dawn
ཤེས-བྱ	validly knowable phenomena
ཤེས-བཞིན	alertness
ཤེས-པ	 ways of being aware of something|cognition 
ཤེས-པ-མངོན-གྱུར-བ	manifest cognition
ཤེས-རབ	discriminating awareness
ཤེས-རབ-ཡེ-ཤེས-ཀྱི-དབང	discriminating deep awareness empowerment
ཤེས-རབ-གྱི-ཕ-རོལ-ཏུ-ཕྱིན-པ	far-reaching discriminating awareness
ཤེས-རབ-ཀྱི-སྤྱན	extrasensory eye of discriminating awareness
ཤེས-སྒྲིབ	cognitive obscurations
ཤིན-སྦྱངས	sense of fitness
ཤིན-ཏུ-ལྐོག-གྱུར	extremely obscure phenomenon
ཤིན-ཏུ-རྒྱས-པ	epic presentations
ཤིན-ཏུ-སྟོང-པ	very void
ཤུགས-ལ-རྟོགས-པ	implicit apprehension
ཤུགས-ལ-ཤེས-པ	indirect cognition
སྐད-ཅིག	 phase|moment 
སྐད-ཅིག-གཅིག-གིས-རྫོགས-སངས-རྒྱས	enlightenment in an instant
སྐད-ཅིག-མའི-སྦྱོར-བ	realizations applied in the last phase
སྐལ-མཉམ-གྱི-རྒྱུ	equal status cause
སྐེམ-བྱེད	make one dried out
སྐུ	Corpus of a Buddha
སྐུ-བཞི	Four Corpuses of a Buddha
སྐུ-གཉིས	Two Corpuses of a Buddha
སྐུ-གསུམ	Three Corpuses of a Buddha
སྐུ-ལྔ	Five Corpuses of a Buddha
སྐུར-འདེབས	repudiation
སྐུས-བྱིན-གྱིས-རླབས-པའི-བཀའ	enlightening words inspired by Buddha's body
སྐྱབ-འགྲོ-ཙམ-པ-བ	mere taking of safe direction
སྐྱབས	safe direction
སྐྱབས-འགྲོ	take safe direction
སྐྱབས-འགྲོ-བསླབས-བྱ	two sets of action for training, which are helpful for maintaining this (safe) direction
སྐྱབས-འགྲོ-ཁྱད-པར-བ	special taking of safe direction
སྐྱབས-མགོན	protector for refuge
སྐྱབས-ཡུལ	objects that indicate a safe direction
སྐྱེ-བ	conception
སྐྱེ-བའི-ཡན-ལག	link of conception
སྐྱེ-མཆེད	stimulators of cognition
སྐྱེ-མཆེད-བཅུ-གཉིས	twelve stimulators of cognition
སྐྱེ-མཆེད-ཀྱི-ཡན-ལག	link of stimulators of cognition
སྐྱེ-སྲིད	conception existence
སྐྱེས-བུ-བྱེད-པའི-འབྲས-བུ	man-made result
སྐྱེས-པའི-རབས	past life accounts
སློབ-བཤད	lobshay
སྨིན-པ	 ripening|ripen 
སྨོན-ལམ	aspirational prayer
སྨོན-སེམས	aspiring bodhichitta
སྨོན-སེམས-དམ-བཅའ-ཅན	pledged state of aspiring bodhichitta
སྨོན-སེམས-སྨོན-པ-ཙམ	merely aspiring state of aspiring bodhichitta
སྣ-ཐུང-སྤུ-སུད-ཀྱི-ངེས-འབྱུང	short-lived all-exited renunciation
སྣང	appearance congealment
སྣང-བ	 appearance-making | cognitive arising | conceptual representation | mental representation|appearance 
སྣང-ལ-མ-ངེས-པ	nondetermining cognition
སྣང-ཡུལ	appearing object
སྔགས	mantra
སྔགས-བཏུས	mantra-gathering
སྔགས-ཀྱི-ཕྱག-ཆེན	mantra mahamudra
སྔགས-པ	ngagpa- (tantric) lay tradition
སྔོན-འགྲོ	preliminary practices
སྔོན-དུས-ཀྱི-སྲིད-པ	predeath existence
སྔོན-གནས-རྗེས-དྲན-གྱི-མངོན-ཤེས	advanced awareness of recollection of past situations
སྙིང-པོའི-ཕྱག-ཆེན	essence mahamudra
སྙིང-རྗེ	compassion
སྙིང-རྗེ-ཆེན-པོ	great compassion
སྙིང-ཐིག	 heart essence teachings|heart essence division 
སོ-མ	fresh and clean
སོ-སོའི-བསླབ-བྱ	individual trainings for each of the Three Gems
སོ-སོའི-སྐྱེ-བོ	ordinary being
སོ-ཐར-སྡོམ-པ	pratimoksha vows
སོར-རྟོག-ཡེ-ཤེས	individualizing deep awareness
སྤོང-བ	riddance
སྤྲོ-བ	zestful vigor
སྤྲོས	fabricate
སྤྲོས-བྲལ	state parted from mental fabrication
སྤྲོས-པ	mental fabrication
སྤྲུལ-སྐུ	 Tulku (reincarnate lama)|Corpus of Emanations 
སྤྱད-པ-རྣམ-པར-སྦྱོང-བའི-དམིགས-པ	object of focus for cleansing one's behaviour
སྤྱི	 conceptual category | mental synthesis|category 
སྤྱི-ལྡོག	items conceptually isolated by categories
སྤྱི-མཚན	metaphysical entities
སྲད-བརྒྱུད	Say lineage
སྲས	spiritual offspring
སྲེད-བྱེད	crave
སྲེད-པ	craving
སྲེད-པའི-ཡན-ལག	link of craving
སྲིད-པ	 further existence | karmic impulse that actualizes a further existence | survival | valid phenomenon|compulsive existence 
སྲིད-པའི-ཡན-ལག	link of further existence
སྲིད-སྲེད	craving in relation to further existence
སྲོག	life-force
སྟོབས	strengthening
སྟོན-མུན	sudden enlightenment
སྟོང	 totally devoid|devoid 
སྟོང-གཟུགས	devoid form
སྟོང-ཉིད-རྟོགས-པ	realize voidness
སྟོང-པ	 void (as noun)|starkness 
སྟོང-པ-བཞི	four voids
སྟོང-པ-ཆེན-པོ	greatly void
སྟོང-པ-ཉིད	voidness
སྟོང-སང	bare absence
ཐ-མལ-འདུ-འཛི	ordinary commotion
ཐ-མལ-གྱི-ཤེས-པ	normal awareness
ཐ-སྙད	 conventional|convention 
ཐ-སྙད-སྤྱོད-ཡུལ	conventional commonsense object
ཐབས-ལམ	path of method
ཐབས-མཁས	skill in means
ཐད-ཀའི-སྤྱི	horizontal mental synthesis
ཐལ-འགྱུར-བ	Prasangika
ཐམས-ཅད-སྟོང-པ	all void
ཐམས-ཅད-ཡོད-པ-སྨྲ-བ	Sarvastivada
ཐར-པ	liberation
ཐེ-ཚོམས	indecisive wavering
ཐེག-ཆེན	Mahayana
ཐེག-དམན	Hinayana
ཐེག-པ	vehicle of mind
ཐིག-ལེ	 creative energy-drops|creative drop 
ཐོབ-པ	acquirement
ཐོབ-པའི-མྱ-ངན-འདས	acquired nirvana
ཐོབ-པའི-སྐྱེས-བུ-བྱེད-པའི-འབྲས-བུ	man-made result that is an attainment
ཐོད-རྒལ	leap-ahead
ཐོས-པ	listening
ཐྲེགས-ཆོད	break-through
ཐུབ-པ	Able One
ཐུགས-ཀྱིས-བྱིན-གྱིས-རླབས-པའི-བཀའ	enlightening words inspired by Buddha's mind
ཐུགས-རྗེ	responsiveness
ཐུན-དྲུག-རྣལ-འབྱོར	Six-Session Yoga
ཐུན-དྲུག-གི-རྣལ-འབྱོར-རྒྱས-པ	Extensive Six-Session Yoga
ཐུན-མོང-མ-ཡིན-པའི-བཏང-སྙོམ	uncommon equanimity
ཐུན-མོང-བའི-བསླབ-བྱ	trainings shared in common for all Three Gems
ཏིང-ངེ-འཛིན	 mental fixation|absorbed concentration 
ཏིང-ངེ-འཛིན-གྱི-མཆོད-པ	offerings of absorbed concentration
ཙ-ཙ	clay votive tablets
ཙམ	mere
ཙེན-མིན	Gradual enlightenment
ཚད-མ	valid cognition
ཚད-མའི-སྐྱེས-བུ	valid source of information
ཚད-མིན	invalid cognition
ཚར-ལུགས	Tsar Tradition
ཚིག-དབང	word empowerment
ཚིགས-སུ-བཅད-པ	metered verses
ཚོགས	 ritual bountiful feast | tsog|network 
ཚོགས-འཁོར	ceremonial round of offering a ritual feast
ཚོགས-བཤད	tsogshay
ཚོགས-ལམ	building-up pathway mind
ཚོགས-སྤྱི	collection mental synthesis
ཚོར-བ	feeling a level of happiness
ཚོར-བའི-ཕུང-པོ	aggregate of feelings of levels of happiness
ཚོར-བའི-ཡན-ལག	link of feeling a level of happiness
ཚུལ-བཅས	concordant
ཚུལ-བཅས-ཡིད-བྱེད	paying attention in a concordant manner
ཚུལ-ཁྲིམས	ethical self-discipline
ཚུལ-ཁྲིམས-དང-བརྟུལ-ཞུགས-མཆོག-ཏུ-འཛིན-པ	holding deluded morality or conduct as supreme
ཚུལ-མིན	discordant
ཚུལ-མིན-ཡིད-བཅས	paying attention in a discordant manner
ཚུལ-མིན-ཡིད-བྱེད	discordant with the manner things actually exist
ཡན-ལག-གི-དམ-ཚིག	auxiliary bonding practices
ཡན-ལག-གི-སྦོམ-པོ	auxiliary thick actions
ཡང-དག-པར-བླངས-པ-ལས-བྱུང-བའི-གཟུགས	forms of physical phenomenon arising from clearly taking them on
ཡང-སྲིད-སྒྲུབ-པའི-ལས	 karmic impulse for further existence|impulse that actualizes a future rebirth 
ཡེ-བབས-ཀྱི-དྲན-པ	deep mindfulness from having dropped down
ཡེ-དོན-ཀུན-ཤེས	primordial deepest alaya
ཡེ-ཤེས	deep awareness
ཡེ-ཤེས-འཕྲིན-ལས-སྐུ	Corpus of Deep Awareness' Enlightening Influence
ཡེ-ཤེས-ཆོས-སྐུ	 Corpus of Deep Awareness' Encompassing Everything|Corpus of Deep Awareness Encompassing Everything 
ཡེ-ཤེས-ལྔ	five types of deep awareness
ཡེ-ཤེས-ཕྱག-རྒྱ	sealing partner for deep awareness
ཡེ-ཤེས-ཀྱི-སྤྱན	extrasensory eye of deep awareness
ཡེ-ཤེས-ཀྱི-ཚོགས	 network of deep awareness|enlightenment-building network of deep awareness 
ཡི-དགས	clutching ghost
ཡི-དམ	Buddha-figure
ཡི-གེ-བཞི	four syllables tradition
ཡིད	general awareness
ཡིད-བདེ-བ	mental happiness
ཡིད-འབྱུང	disgust
ཡིད-འོང-བྱམས-པ	heartwarming love
ཡིད-བྱེད-བྲལ-བ	state parted from taking to mind
ཡིད-ཆེས-ཀྱི-དད-པ	belief in a fact based on reason
ཡིད-དཔྱོད	presumptive cognition
ཡིད-ཀྱི-རང-བཞིན-གྱི-གཟུགས	forms of physical phenomena having the functional nature of mind
ཡིད-ཀྱི-རྣམ-ཤེས	mental consciousness
ཡིད-ལ-བྱེད-པ	 taking to mind|attention 
ཡིད-ལ-མ-བྱེད-པ	not taking to mind
ཡིད-ལུས	mental body
ཡོད-པ	existents
ཡོན-ཏན	good qualities
ཡོངས-གྲུབ	thoroughly established phenomena
ཡོངས-སུ-མྱ-ངན-འདས	parinirvana
ཡུལ	object
ཡུལ-ཅན-གྱི-འོད-གསལ	cognitive clear light
ཡུལ-གྱི-འོད-གསལ	object clear light
ཟག-བཅས	tainted
ཟག-བཅས-ཀྱི-ཕུང-པོ	tainted aggregates
ཟག-མེད	untainted
ཟག-མེད-ཀྱི-ཕུང-པོ	untainted aggregates
ཟག-པ-ཟད-པ	degree of depletion of the various tainted factors
ཟག-པ-ཟད-པའི-མངོན-ཤེས	advanced awareness of the depletion of tainted factors
ཟང-ཐལ	all-permeating
ཟང-ཟིང	upsetting
ཟང-ཟིང-མེད-པ	nonupsetting
ཞལ-གདམས	guideline teachings
ཞལ-ལུང	personal instructions
ཞལ-ནས-གསུང-པའི-བཀའ	enlightening words spoken from Buddha's own lips
ཞེ-སྡང	hostility
ཞེ-སྡང-མེད-པ	imperturbability
ཞེན-པ	conceptually cling
ཞེན-པ-བཞི-བྲལ	parting from the four types of clinging
ཞེན-ཡུལ	conceptualized object
ཞི-བ	 pacifying suffering | serene|pacification 
ཞི-བྱེད	pacifier
ཞི-གནས	 zhinay|stilled and settled state of mind 
ཞི-མཐའ	extreme of remaining in tranquil peace of nirvana
ཞིག-པ	previously-having-perished
ཟུང-འབྲེལ	joined pair
ཟུང-འཇུག	unified pair
