འབའ-འཛར	(PH) vajra [arch. spelling]
འབག-མ	(PH) mask
འབགས-རེངས	(PH) riffraff
འབོགས-ཆོ-ག	(PH) rites for deriving the most success
འབོགས-ཆོག	(PH) rites for deriving the most success
འབྲ-གོ-ཅན	(PH) Kharjūrika
འབྲལ-བའི-སྡུག-བསྔལ	(PH) suffering of self-denial
འབྲལ-མེད	(PH) continuously; inseparably; without separation
འབྲས-བུ-གཅིག-པ	(PH) sameness of effect
འབྲོག-ས	(PH) nomadic area
འབུམ-ཕྲག-ཞེ-ལྔ	(PH) four million five hundred thousand
འབུམ-ཚོ	(PH) hundreds of thousands
འབུར-པོ	(PH) protuberance
འབྱིན-པ-པོ	(PH) creator
འབྱུང-འཇུག	(PH) emerging and entering; inhalation and exhalation
འབྱུང-བའི-གནས	(PH) source
འཆབ	(PH) concealment
འཆད-རྩོད-རྩོམ-པ	(PH) explication; debate; and composition
འཆག-ཁང	(PH) outhouse; latrine
འཆར-བྱེད	(PH) [King] Udayana [of the Vatsa Kingdom]
འཆི-བའི-ཆོས-ཅན	(PH) being mortal; subject to death
འཆི-མེད-ལྗོན-ཤིང	(PH) tree of immortality
འཆི-ཚད	(PH) dying
འདབ-བརྒྱ	(PH) the hundred-petaled (lotus)
འདབས-ན	(PH) nearby
འདམ	(PH) mud
འདས	(PH) past [phenomena]; [phenomena that exist in the] past
འདས-ལམ-མཉམ-བཞག	(PH) meditative equipoise of a supramundane path
འདས-པའི-རྐྱེན	(PH) past tense
འདི-འདྲ-ཞིག	(PH) like
འདི-འོག-མ	(PH) later sections of this [book]
འདི-ཀོ	(PH) all of these
འདོད-བྱ	(PH) desired objective; that which one wishes for
འདོད-ཆགས-ཚུལ-བཞི	(PH) four modes of desirous attachment
འདོད-ལྷ	(PH) god of the Desire Realm
འདོད-ཉོན-གྱི-སུམ-གཉིས	(PH) two of the three sets of the afflictions of the desire realm
འདོད-པའི-ལོངས-སྤྱོད-ལྔ	(PH) five sensual enjoyments of desire
འདོད-པའི-ས	(PH) the level of the desire realm
འདོད-པར-བྱ-བ	(PH) object of desire; that which one wishes for
འདོད-སེམས-ཅན	(PH) desirous sentient beings
འདོད-ཚུལ	(PH) mode of asserting; mode of assertion
འདོགས-ཅན	(PH) subscribed
འདོམས	(PH) genitalia
འདྲེ-བགེགས	(PH) [type of demon]
འདྲེའི-གཟན	(PH) flesh-eating demons
འདྲེག-མཁན	(PH) barber
འདུ-མ-བགྱིས	(PH) uncompounded
འདུ-མ-བགྱིས-པ	(PH) uncompounded
འདུ-ཤེས-ཕུང-པོ	(PH) aggregate of discrimination
འདུག-པའི-གནས	(PH) a place
འདུལ-གྲྭ	(PH) training center
འདུས-བསགས	(PH) collections and aggregations
འཛམ-བུའི-ཆུ-གསེར-མ	(PH) River Gold of Jambudvīpa
འཛམ-བུའི-གསེར-སྦྱངས	(PH) pure River Gold of Jambudvīpa
འཛིན-མ	(PH) field; ground; earth
འཛིན-པ-ཕྱོགས-གཅིག-པའི-ཏིང-ངེ-འཛིན	(PH) a meditative stabilization of partiality with respect to apprehenders [of subjects]
འཛིན-སྟངས	(PH) tying wrists
འཛུམ-དཀར	(PH) brilliant countenance
འཛུམ-པའི-བཞིན	(PH) a smiling face
འཛུམ-ཕྲེང	(PH) garland of blossoms
འགག-མེད	(PH) ceaseless; without hesitation
འགག-པ-མེད་	(PH) ceaseless; without hesitation
འགག-པ-མེད-པ	(PH) ceaseless; without hesitation
འགགས-མེད	(PH) ceaseless; without hesitation
འགལ-བ-ལྟར-སྣང-ལྔ	(PH) five facsimilies of contradiction
འགལ-བའི-ཚིག	(PH) contradictory words
འགན-ཁུར-གྱི-དགེ-རྒན	(PH) teacher who bears responsibility
འགངས	(PH) importance
འགོག-པ-མཐོང-སྤང-ཉོན-མོངས-བཅུ	(PH) ten afflictions to be abandoned by the path of seeing [related to the Noble Truth of] Cessation
འགྲམ	(PH) banks; shores
འགྲམ-པ	(PH) race
འགྲན-སེམས	(PH) competitiveness
འགྲེལ-བཤད-ཚིག-གསལ	(PH) [Dharmamitra's] Clear Words; An Explanatory Commentary [on (Maitreya's) 'Ornament for Clear Realization"]
འགྲིག-ལམ	(PH) regulation; rule
འགྲིམས-འགྲུལ	(PH) transport
འགྲོ-བ	(PH) transmigration; rebirth
འགྲོ-བ-འདུལ-བ	(PH) Sakalajagadvinaya
འགྲོ-བ-ཐམས-ཅད-འདུལ-བ	(PH) Sakalajagadvinaya
འགྲོ-ལྡིང-པ	(PH) Dravidian
འགྲོ-སྐྱབས	(PH) refuge of transmigrators
འགྲོས	(PH) progression; motion
འགྱོད	(PH) contrition
འགྱུར-གྱི-ཕྱག	(PH) translator's homage
འགྱུར-ཚོད	(PH) length of translation
འཇམ-དཔལ-ཚེ-བདག-ནག-པོ	(PH) Black Manjuśrī (?)
འཇམ-མཉེན	(PH) soft and slender
འཇམ-རྩུབ	(PH) smooth [and/or] coarse
འཇིག-རྟེན-འདུས-པ	(PH) Consummation of the Worlds [name of the Jain place of liberation]
འཇིག-རྟེན-དབང	(PH) Lokeśvara
འཇིག-རྟེན-དབང-ཕྱུག	(PH) Lokeśvara
འཇིག-རྟེན-གྱི-ཁམས-མི-མཇེད	(PH) the [three thousand-fold] Saha world-system
འཇིག-རྟེན-གྱི-མངོན-སུམ-ཚད-མ	(PH) valid worldly perception
འཇིག-རྟེན-ལས-འདས-པའི-མཉམ-བཞག	(PH) supramundane meditative equipoise
འཇིག-རྟེན-ལས-འདས-པའི-མཉམ-བཞག-རྣམ-པར-མི-རྟོག-པའི-བློ	(PH) non-conceptual awarenesses of supramundane meditative equipoise
འཇིག-རྟེན-པ-དང-ཉན-ཐོས-དང-རང-སངས-རྒྱས	(PH) worldly beings; Śrāvakas; and Pratyekabuddhas
འཇིག-རྟེན-པའི-དགེ-བ	(PH) worldly virtues
འཇིག-རྟེན-པའི-མཉམ-བཞག-བསམ-གཏན-གཟུགས-མེད	(PH) [four] concentrations and [four] formless absorptions of worldly meditative equipoise
འཇིག-རྟེན-པའི-རྗེས-ཐོབ	(PH) mundane states subsequent to meditative equipoise
འཇིགས-པའི-མུན-ནག	(PH) terrifying black darkness
འཇིགས-རྟེན-གྱི-ཁམས-མི-འདྲ-བ	(PH) different world-systems
འཇིགས-རྟེན-གྱི-ཁམས-མི-འདྲ-བ-བརྒྱ	(PH) one hundred different worldly realms
འཇིགས-རྟེན-ལས-འདས-པར-བསྟོད-པ	(PH) Nāgārjuna’s Praise of the Supramundane (lokātītastava)
འཇོ-སྒེག-རྡོ-རྗེ	(PH) Līlāvajra / Vilāsavajra
འཇུག-པ-གཟུང-རྟོག	(PH) conception of the true existence of objects to be engaged in [by Bodhisattvas]
འཇུག-པ-གཟུང-རྟོག-དགུ	(PH) the nine conceptions of the true existence of objects to be engaged in [by Bodhisattvas]
འཇུར-གྱིས	(PH) suddenly
འཁོན-འཛིན	(PH) resentment
འཁོན-ཅན	(PH) full of resentment
འཁོར-འདུས-ཐེབས	(PH) assembly
འཁོར-བ	(PH) cyclic existence
འཁོར-བའི-ཉེས-པ	(PH) faults of samsara
འཁོར-དང-ལོངས-སྤྱོད	(PH) attendants and wealth
འཁོར-དེ-ཉིད	(PH) that very assembly
འཁོར-གྱི-གླིང	(PH) surrounding continents
འཁོར-ལོ	(PH) wheel; channel wheel
འཁོར-ལོ-བསྒྱུར-བ	(PH) wheel [turning] monarch
འཁོར-ལོ-ལྔ	(PH) five cakras
འཁོར-ལོ-སྒྱུར-བ	(PH) wheel [turning] monarch
འཁོར-ལོ-སྒྱུར-བའི-རྒྱལ-པོ	(PH) wheel [turning] monarch
འཁོར-མོ-འཇིག	(PH) Varanasi
འཁོར-མོ-འཇིག-གི-ཡུལ-དུ-བདུད	(PH) the demons of the surrounding transient world
འཁྲུལ-འཁོར	(PH) yantra; device; magic wheel; machine; yogic exercises
འཁྲུལ-འཁོར-བསྲེ-བ-བརྒྱ-བརྒྱད-པ	(PH) Hundred and Eight Combined Yogic Exercises
འཁྲུངས-དཔེ	(PH) formulary
འཁུན-བུ	(PH) sigh; sighing
འཁྱགས-རུམ	(PH) ice-slip
འཁྱར-འཁྱོར	(PH) crooked
འོད-འཁོར	(PH) nimbus
འོད-འཕྲོ	(PH) light-rays
འོད-འཕྲོད-བ	(PH) The Radiant [the fourth bodhisattva ground]
འོད-གསལ-གྱི-ལྷ	(PH) Ābhāsvara gods
འོད-སྟོང-ཅན	(PH) the possessor-of-a-thousand-lights (the Sun)
འོད-སྟོང-ལྡན-པ	(PH) the possessor-of-a-thousand-lights (the Sun)
འོད-ཟེར-ཅན	(PH) Mārīcī
འོད-ཟེར-གོ-ཆ	(PH) [Nepali King] Aṃśuvarman
འོག-ཁང	(PH) cellar
འོག-མ-འོག-མ	(PH) lower and lower
འོག-ཏུ	(PH) after; later
འོལ-ཕྱི	(PH) unclear
འོན-ཀྱང	(PH) moreover; however
འོན-ཏེ	(PH) or else; yet
འོས-པ	(PH) suitable; worthy
འོས-པ-ཉིད	(PH) most suitable; most appropriate
འཕགས-མ-སྒྲོལ-དཀར	(PH) Ārya White Tara
འཕང	(PH) height
འཕང-ཐང	(PH) high ground; top soil
འཕེལ-བཞིན	(PH) intensifying
འཕེལ-བཞིན-པ	(PH) intensifying
འཕོ-ཆགས	(PH) desire for emission
འཕོ-ཆུང	(PH) small movement
འཕྲལ	(PH) adventitious; immediately; temporary
འཕྲལ-དུ	(PH) daily; every day
འཕྲལ-ཕུགས	(PH) superficially or ultimately
འཕྲང	(PH) dangerous passage
འཕྲེང-བ	(PH) attachment
འཕྲིག	 (PH) quiver; tremble|(PH) doubt 
འཕྲོས	(PH) elaboration; indication; mention
འཕྲོས-དོན	(PH) extension of the meaning; subsidiary topics
འཕྲོས-གླེང	(PH) conversation
འཕྲུལ-འཁོར	(PH) machinery; engine; magical wheel
འཐད-པ	(PH) correct reasonings; correctness; feasibility
འཚམས-ཤིག	(PH) accordingly
འཚམས-ཤིག-ནས	(PH) accordingly
འཚིག	(PH) spite
འཚོ-བ-ནར-མ	(PH) general support [provided by the laity to the ordained sangha of food and so forth]
འཚོར-བ	(PH) sensation; experience
འུ-རང	(PH) I
འུན-ཤིང-ཀོང-ཇོ	(PH) [Chinese princess] Wencheng
ཨ-ལི	(PH) the vowels
ཨ-ཝ-དྷཱུ-ཏི-པ	(PH) Avadhutipa [Maitripa]
བ-བྱུང-སྣ-ལྔ	(PH) five various products of a cow
བ-དན-དཀར-པོ	(PH) a white banner
བ-ལང-གི-རྗེས	(PH) a cow's footprint
བ-ལང-གི-རྨིག-རྗེས	(PH) a cow's footprint
བ-སུ-མི-ཏྲ	(PH) Vasumitra
བ-ཞོ	 (PH) cow's yogurt|(PH) cow's yogurt 
བད-དམ	(PH) almond
བད-ཀན	(PH) phlegm
བད-ས	(PH) Vatsa [kingdom]
བད-ས-ལ	(PH) Vatsa [kingdom]
བག	(PH) attention; care; caution
བག-ཅན	(PH) conscientious
བག-ཆགས-བརྟན	(PH) stable predispositions
བག-ཆགས-བརྟན-བྱུང-གི-རིག-པ	(PH) a knower that arises from stable karmic predispositions
བག-དང-ལྡན	(PH) conscientiousness
བག-དང-ལྡན-པ	(PH) conscientiousness
བག-མེད	(PH) non-conscientiousness; carelessness; unconcerned
བཻ-དཱུརྱ	(PH) lapis lazuli; vaiḍūrya
བཻདཱུརྱ	(PH) lapis lazuli; vaiḍūrya
བལ-པོའི-མཐིལ	(PH) central Nepal
བན-ལོག	(PH) defrocked monk
བར	(PH) upto
བར-འདའ-བ	(PH) beings who have transcended the intermediate-state 
བར-འགའ	(PH) sometimes
བར-བར-དུ	(PH) interspersed
བར-ཆད-བཅུ-དྲུག	(PH) sixteen obstacles
བར-ཆད-བདུད	(PH) Vigṅa-mārā
བར-ཆེད	(PH) interruption
བར-ཆོད-པའི-ཚད-མའི-འབྲས-བུ	(PH) the interrupted results of valid cognition
བར-དུ	(PH) until; throughout; while
བར-མ-ཆད-དུ	(PH) uninterruptedly
བར-མ-དོར	(PH) prematurely
བར-ཤོད-འོག-མ	(PH) lower storey
བར-སྐབས	(PH) between sections; interstitial
བཅའ-སྒ	(PH) dried ginger
བཅས-རང	(PH) transgressions [of vows] and natural [offenses]
བཅོམ-ལྡན-འདས-དཔལ-བརྩེགས-རྒྱལ-པོ	(PH) the Transcendent Victor Śrīkūṭa-rāja
བཅོམ-ལྡན-འདས-དཔལ-བརྩེགས-རྒྱལ-པོ-དེ-བཞིན-གཤེགས-པ	(PH) the Tathāgata; the Transcendent Victor Śrīkūṭa-rāja
བཅོམ-ལྡན-འདས-སཱ-ལའི-དབང-པོའི-རྒྱལ-པོ-འབྱུང-བ	(PH) the Transcendent Victor Sālendra-rājācāra
བཅོམ-ལྡན-བདེ-གཤེགས	(PH) the Transcendent Victor; the One-Gone-to-Bliss
བཅོས-མིན-གྱི-མྱོང-བ	(PH) non-artificial experience 
བཅུ	(PH) ten
བཅུ-བཅུ	(PH) ten each
བཅུ-དྲུག-ཆ	(PH) full-moon-like (lit. having all 16 parts ("lunar digits") [of the full moon])
བཅུ-གསུམ-རྡོ-རྗེ-འཛིན-པའི-ས	(PH) thirteenth ground vajra-holder
བདག	(PH) self; ″I″
བདག-འཛིན	 (PH) grasping at a self; conception of a self|(PH) grasping at a self; conception of a self 
བདག-འཛིན-འཁྲུལ-པ	(PH) mistaken grasping at a self; mistaken conception of a self
བདག-འཛིན-གྱི-ཞེན-ཡུལ	(PH) conceived object of self-grasping
བདག-འཛིན-ལྷན-སྐྱེས	(PH) innate conception of a self
བདག-དབང-སོགས	(PH) a self which is independent and so on [i.e.; and permanent; unitary]
བདག-མེད-པའི-ལྟ-བ-རྣམ-པར-དག-པ	(PH) the correct view of selflessness
བདག-པོ	(PH) dominant [condition]; master; sovereign; lord
བདག-པོར-འཛིན-པ	(PH) conception of ownership; conception of sovereignty
བདག-པོས-ཡོངས-སུ-འཛིན-པ	(PH) conception of ownership; conception of sovereignty
བདག-ཏུ-འཛིན-པ	(PH) conception of a self
བདམས-བསྒྲིགས	(PH) collection of articles
བདེ-བ	(PH) bliss; abiding
བདེ-བ-དང-ཡིད-བདེ-བ	(PH) bliss and mental happiness
བདེ-བ-རྒྱུན-མི-འཆད	(PH) uninterrupted bliss
བདེ-བླགས-ཏུ	(PH) easily
བདེ-ཅན	(PH) Sukhāvatī [name of a Buddhist Pure Land]
བདེ-ཅན-བདེ-བ	(PH) bliss of Sukhāvatī
བདེ-ཆེན-ལམ-བཟང	(PH) excellent path of great bliss
བདེ-གསལ	(PH) bliss and clarity
བདེ-གསལ-ཆ	(PH) factor of bliss and clarity
བདེ-ལེགས	(PH) goodness; auspiciousness
བདེ-མང	(PH) much happiness; many forms of happiness
བདེ-སྟོང-ལོངས-སྤྱོད-རྫོགས-སྐུ	(PH) Emanation Body of bliss-and-emptiness
བདེན-འཛིན	(PH) conception of true existence
བདེན-དངོས	(PH) truly [existent] thing(s)
བདེན-པ-རེ-རེ	(PH) each of the [Four Noble] Truths
བདེན-པའི-ངག	(PH) true speech
བདེན-སྟོང-སྒྱུ-མ-ལྟ-བུ	(PH) being like an illusion and empty of true existence
བདེར-གཤེགས	(PH) sugata
བདོག-པའི-རྟེན	(PH) personal offerings
བདུད-བཞི	(PH) four devils (māra)
བདུད-རྩི-སྣ-ལྔ	(PH) five various [types of] nectars
བདུད-རྩི-ཐབ-སྦྱོར	(PH) Āmṛtakuṇḍalī
བདུན-ཕྲག	(PH) week
བེམ-ཤེས-ལྡན-མིན-འདུ-བྱེད	(PH) matter; consciousness; and non-associated compositional factors
བགེགས-གཏོར	(PH) "Gektor" [torma offering to an obstructing being]
བགེགས-རིགས	(PH) types of obstructing spirits
བྷར-མ	(PH) Burma; Burmese
བི-ཀྲ-མ-ལ-ཤི-ལ	(PH) Vikramalaśila
བི-ཀྲ-མ-ཤི-ལ	(PH) Vikramalaśila
བི-ཀྲ-མའི-ལོ	(PH) Vikrama year
བཀའ-བློན-རོགས	(PH) Assistant Cabinet Minister
བཀའ-བསྒོ-བ	(PH) order; command
བཀའ-དྲིན-གཟོ-བ	(PH) grateful; one who remembers kindness
བཀའ-ལུང	(PH) power
བཀའ-རབ-འབྱམས-པ	(PH) Rap-jam-pa [degree]
བཀའ-རྒྱ-དམ-པོ	(PH) tight seal of secrecy
བཀའ-རྟགས	 (PH) signifier of the Word [of the Buddha]|(PH) decree; command; sealed order 
བཀའ-རྟགས-ཀྱི-ཕྱག-རྒྱ-བཞི	(PH) four seals that are the signifiers of the Word [of the Buddha]
བཀག-པ	(PH) negation; that which is forbidden
བཀྲ-བ	(PH) shining; beautiful; variegated
བཀྲ-བའི-སྐད-འབྱིན	(PH) producing a beautiful sound (n. of a bird)
བཀྲ-མི-ཤིས-པ	(PH) bad luck
བཀྲེན	(PH) poor
བཀྲོས-ཕོར	(PH) engraving
བཀུར-རྙེད	(PH) wealth and respect
བླ	(PH) payment
བླ-བརྒྱུད-གསོལ-འདེབས	(PH) supplication to the gurus of the lineage
བླ-དྭགས-ཚིག	(PH) synonym
བླ-ཁག	(PH) monastic head; monastic leader
བླ-མ	(PH) lama; unsurpassed
བླ-མ-དབུ-མཛད	(PH) chant master
བླ-མ-ཁྱད-ཆོས-གསུམ-ལྡན	(PH) guru endowed with the three distinguishing features
བླ-མ-སྤྱན-རས-གཟིགས	(PH) Spiritual Master; Avalokiteśvara
བླ-མའི-གནས-གསུམ	(PH) The Lama's three points [brow; throat; and heart]
བླ-ན	(PH) above
བླ-ཕྱག	(PH) treasurer
བླ-ཕྱག-ཟུར-པ	(PH) former treasurer
བློ-གྲོས	(PH) intellect; intelligence; thought
བློ-གྲོས-ཆེན-པོ	(PH) Mahāmati [p.n. a bodhisattva, who is the main interlocuter in the Laṅkāvatāra-sūtra]
བློ-གྲོས-ལྡན	(PH) intelligent
བློ-གྲོས-མཚོ	(PH) Sagaramati
བློ-གྲོས-རྒྱ-མཚོ	(PH) Sagaramati
བློ-གཏེར-རྒྱལ-བ	(PH) victorious treasury of wisdom [epithet of Mañjuśrī]
བློ-གཟུ-བོ	(PH) open-minded
བློ-ལྡན-བྱང-ཆུབ-སེམས-དཔའ	(PH) intelligent bodhisattvas
བློ-ལྡན-བྱང-ཆུབ-སེམས-དཔའ-ས-བཞི-བ	(PH) intelligent bodhisattvas of the fourth ground
བློ-ལྷན-སྐྱེས	(PH) an innate awareness
བློ-མ-བདེ	(PH) unhappy
བློ-ངོ	(PH) perspective
བློ-སེམས-མཚོ	(PH) Bodhisattva Rakṣita
བློའི-དབང-པོ-ལྔ	(PH) five mental faculties
བློན-འབངས	(PH) attending minister
བློན-པོ-རིན-ཆེན	(PH) precious minister
བླུན-པ	(PH) dull; foolish; stupid; deluded
བླུན-པོ	(PH) dull; foolish; stupid; deluded
བླུན-རྨོངས	(PH) confused fool
བོད	(PH) Tibet; vocative case; imperative verbal form
བོད-ཁམས-གླིང-དགུ	(PH) Nine regions of Tibet
བོད-པ	(PH) vocative case
བོད-པའི-ཚིག	(PH) word in the vocative case
བོད-སྔ-མ-ཁ-ཅིག	(PH) an earlier Tibetan [scholar]
བོད-སྤྱི	(PH) all of Tibet; Tibet in general
བོད-ཡིག	(PH) Tibetan script; Tibetan letters
བོང-ཆེ	(PH) vast; massive
བོང-ཚོད	(PH) dimension; size
བྲག-བརྐོས-རི-མོ	(PH) petroglyphs
བྲག-མཐོ	(PH) rocky hill
བྲག-སྲིན-མོ	(PH) rock ogress
བྲམ-ཟེ-རྐང-མིག	(PH) the Brahmin Akṣapāda (a.k.a.; Gautama)
བྲན	(PH) servant; slave
བྲན-མོ-རྒན-མོ	(PH) old maid servant; old (female) servant
བརྡའ-ཆད	(PH) terminology
བརྡའ-སྤྲོད-ཀུན-བཤད-ཀྱི-བཏགས-མིང	(PH) grammatical name; Sanskritic name as a grammarian [on the completion of the course of study of the three grammatical systems the successful student was given a grammatical name under which he wrote any works dealing with philological studies; literature; mathematics and astronomy; and medicine.]
བརྒྱ-ལམ	(PH) rare
བརྒྱ-ལམ-ན	(PH) rarely; occasionally
བརྒྱད-ཅུ-རྩ-གཅིག	(PH) eighty-one
བརྒྱད-ཀ	(PH) all eight
བརྒྱུད-འཛིན-ཆོས-བདག	(PH) master who holds the lineage transmission
བརྒྱུད-ནས-སྐྱེད-བྱ	(PH) that which is indirectly produced
བརྒྱུད-པའི-བྱིན-རླབས	(PH) the blessings of the lineage
བརྗེད-མེད	(PH) unforgetful
བརྗེད-ངེས	(PH) forgetfulness
བརྗེད-པ-མེད-པ	(PH) unforgetful
བྲོད	(PH) pleasure
བརྟག-པ	(PH) ritual text
བརྟན-པོ	(PH) firm; stable
བརྩེགས-མ	(PH) piled up; piled one on top of the other
བརྩེར	(PH) merciful
བརྩོན-ཞིང-འཚོལ-བ	(PH) effort and searching
བརྟུལ-ཞུགས-འཛིན-པ	(PH) one who holds the vows of conduct (vrata)
བརྟུལ-ཞུགས-པ	(PH) holder of vows of conduct (vrata)
བྲུ-ཤ	(PH) Brushal (Gilgit)
བསམ-གཏན	(PH) concentration
བསམ-གཏན-གྱི-གནས-རིས	(PH) Concentration Realms
བསམ-གཏན-གྱི-གནས-རིས-བཞི	(PH) four Concentration Realms
བསམ-གཏན-གྱི-ས	(PH) levels of concentrations
བསམ-གཏན-གྱི-སྡོམ-པ	(PH) concentration discipline
བསམ-གཏན-གྱི-སྐྱོན-བརྒྱད	(PH) eight faults of concentration
བསམ-གཏན-གྱི-ཡན-ལག-ལྔ	(PH) five concentration factors
བསམ-གཏན-ལས-ལངས-པའི-འདོད-སེམས	(PH) a mind of the desire realm of one who has arisen from a concentration
བསམ-གཏན-ཕྱི-མ-གསུམ	(PH) last three concentrations
བསམ-ཁྲལ	(PH) misgiving; concern
བསམ-པ-ལྷུན-གྲུབ-མ	(PH) Prayer That Fulfills All Aspirations
བསམ-པ-ཐག-པ	(PH) unusual attitude; earnest intention
བསམ-པའི-ཡོན-ཏན	(PH) qualities of intention
བསམ-སྦྱོར	(PH) thoughts and actions
བསམ-ཡས	(PH) Sam-ye [Temple]
བསམ-ཡས-མི-འགྱུར-ལྷུན-གྱིས-གྲུབ-པ	(PH) Samye Mi-gyur Hlun-gyi-drup-pa [Temple] ("spontaneous fulfillment of unchanging limitless aspirations")
བསེ-ཡབ	(PH) tamarind
བསྒོ-བ	(PH) command; order
བསྒྲུབ-བྱ	 (PH) that which is to be proven (probandum); thesis|(PH) that which is to be proven (probandum); thesis 
བསྒྲུབ-པར-བྱ-བ	(PH) that which is to be proven (probandum); thesis
བསྒྱུར-བཅོས	(PH) correction; corrected translation
བཤའ-རི	(PH) slaughterhouse
བཤང-གཅི	(PH) feces and urine
བཤར-སྒོམ	(PH) reviewing meditation; glance meditation
བཤས-ར	(PH) slaughterhouse
བཤེས-གཉེན	(PH) virtuous friend; spiritual teacher
བསྐལ-པ-རྫོགས-ལྡན	(PH) age of perfection [first of the four ages of the aeon]
བསྐོལ-བའི-ཐང	(PH) decoction (of)
བསྐོལ-ཐང	(PH) decoction (of)
བསྐོར-མགོ	(PH) computational sequence
བསྐུལ-བའི-སྤང-བ	(PH) offense of encouraging [gifts]
བསྐུལ-བྱེད	(PH) Cunda
བསྐུལ-བྱེད-རྡོ-རྗེ-མ	(PH) Cundavajrī
བསྐུལ-ཚིག	(PH) imperative [grammatical term]
བསྐྱང-ནུལ	(PH) clay-floor
བསྐྱར-ཟློས	(PH) repeated; repetition
བསྐྱེད-དང-རྫོགས-པ-ཟུང-འཇུག	(PH) union of generation and completion [stages]
བསླབ-གསུམ	(PH) Three Trainings
བསླབ-གསུམ-འབྲས-བུ-དང-བཅས-པ-ལྷག-ཚུལ-གྱི-ཁྱད-པར	(PH) the feature of an enhancement of the three trainings together with their fruit
བསླུ-བྲིད	(PH) deceptive seduction; alluring spell
བསླུ-བྲིད-ཚིག	(PH) deceptively seductive words
བསླུ-ཡོན	(PH) ransom
བསྔགས-ལྡན	(PH) Kaṇḍaka
བསྔོ-བ	(PH) dedication
བསྙེན-བཀུར-བྱ-བ	(PH) object of respect; object of veneration
བསྙེན-སྒྲུབ-ལས-གསུམ	(PH) prior approximation; attainment; and actitives
བསོད-སྙོམས-ཆེན-པོ	(PH) "the great almsman" (en epithet of Śākyaśrībhadra)
བསོད-སྙོམས-ཀྱི-ཞལ-ཟས	(PH) alms food
བསྲབ-མོ	(PH) diminishment
བསྲབ-པའི-ས	(PH) ground of diminishment
བསྟབས-པ	(PH) that which is offered
བསྟན-པ	(PH) one who is oriented [a certain way]
བསྟན-པ-ཉིད	(PH) indication; implication; this very demonstration
བསྟན-ཕ	(PH) instructional lineage
བསྟོས	(PH) treatise; composition; work
བཏགས-འཛིན-རྟོག-པ	(PH) conception of the true existence of subjects (i.e., persons) as being imputedly existent
བཏགས-འཛིན-རྟོག-པ-དགུ	(PH) the nine conceptions of the true existence of subjects (i.e.; persons) as being imputedly existent
བཙག	(PH) red ochre
བཙན	(PH) a disease-causing demon; force; power; strength
བཙན-འཛུལ-པ	(PH) attacker
བཙན-པོ	(PH) king; ruler; emperor
བཙོ-བླག-མ	(PH) washer woman
བཙོ-མ	(PH) refined; purified; purified [substance]
བཙུན-ཁྲལ	(PH) monastery
བཙུན-པ	(PH) practical application
བཏུང-བ-ཞིམ-པོ	(PH) pleasant drink
བུ-ག-ཅན	(PH) with holes
བུ-ལོན-གྱི-དཔང	(PH) guarantee on a loan
བུ-སློབ-ཀུན	(PH) all my disciples
བུའི-འོད-གསལ	(PH) 'son' clear light
བུད-མེད-ཆོལ	(PH) confused woman
བུལ-མྱུར	(PH) quick or slow
བུམ-པ-བཟང	(PH) the good vessel
བྱ-བྱེད	(PH) activities
བྱ-རྫོགས	(PH) completed action
བྱ-རྒོད-ཀྱི-ཕུང-པོའི-རི	(PH) Vulture Peak Mountain
བྱ-རོག-དང-ཏ-ལའི-ཚུལ	(PH) the manner of [the parable of] the crow and the palmyra fruit
བྱ-ཐབས	(PH) opportunity; recourse; course of action
བྱམས-དགོན	(PH) Protector Maitreya
བྱམས-པ-མཐོང-གྲོལ	(PH) byams pa mthong grol (n. of a diety)
བྱང-ཆུབ-གསུམ-གྱི-ཁང-བཟང	(PH) the good houses of the three enlightenments
བྱང-ཆུབ-ཀྱི-ཕྱོགས-ཀྱི-སུམ-ཅུ-རྩ-བདུན	(PH) thirty-seven branches of enlightenment
བྱང-ཆུབ-ཀྱི-ཕྱོགས-སུམ-ཅུ-རྩ-བདུན	(PH) thirty-seven branches of enlightenment
བྱང-ཆུབ-ཕྱོགས-མཐུན-ཆོས	(PH) phenomena/doctrines that are harmonies with enlightenment
བྱང-ཆུབ-སེམས-དཔའ-སེམས-དཔའ-ཆེན-པོ-ལགས-ན-རིན-པོ-ཆེ	(PH) the Bodhisattva-mahāsattva Ratnapāṇi
བྱང-ཆུབ-སྤྱོད	(PH) bodhisattva deeds
བྱང-གི-གཏུམ-མོ	(PH) ″inner heat″ (caṇḍālī) north [left] channel at the heart
བྱང-ངོས	(PH) north side; northern direction
བྱང-སེམས-ས-བཅུ-པ	(PH) ten stages of the bodhisattva
བྱང-སེམས-ས-བཅུ-པ-པ	(PH) a tenth ground Bodhisattva
བྱས-ཟིན	(PH) result
བྱེ	(PH) sand
བྱེ-བ-ཁྲག-ཁྲིག-འབུམ-ཕྲག	(PH) ten billion trillion (lit. ten million ten billion hundred thousands; i.e.; 10^^22)
བྱེ-བ-ཁྲག-ཁྲིག-ཕྲག-འབུམ	(PH) ten billion trillion (lit. ten million ten billion hundred thousands; i.e.; 10^^22)
བྱེ-བ-སྟོང-ཕྲག	(PH) ten billion
བྱེ-རིག	(PH) Nyāya-Vaiśeṣika
བྱེ-རིག-གཉིས	(PH) both the Vaiśeṣikas and the Naiyāyikas
བྱེ-ཐེམ	(PH) sand dune
བྱེད-ལས-ཆོས	(PH) functional phenomena
བྱི-ཕོ	(PH) young man
བྱིན-གྱི-བརླབས	(PH) influence; blessing
བྱིང-བ	(PH) sinking
བྱིངས	(PH) verbal root
བྱོལ-སོང	(PH) direction
བྱུང-དཀའ-བ	(PH) difficult to tame
བྱུས	(PH) strategy; political strategy
བྱུས-ཉེས	(PH) faulty strategy
བཟང-པོ-སྤྱོད-པའི-སྨོན-ལམ	(PH) Aspirational Prayer of the Deeds of Samantabhadra (samantabhadracaryāpranidhāna)
བཟེ-རེ-ཅན	(PH) helpless
བཟེ-རེ-ཅན-གྱུར-ཉིད	(PH) extreme helplessness
བཞག-པ	(PH) deposit
བཞེད-པ	(PH) accepted position
བཞི-མདོ	(PH) four-way crossroads
བཞིན	(PH) face
བཞིན-ལག	(PH) face and hands
བཞིན-པ	(PH) [verbal post-positional phrase indicating present participle or continuative]
བཞོན-པ	(PH) mount; coach; carriage
བཞུགས-གྲལ	(PH) seated ranks
བཟློག-པ-པོ	(PH) something that blocks; something that wards off
བཟོ-ལུགས	(PH) style
བཟོ-རྒྱུན	(PH) lineage of artistic style
བཟོད-ལྡན	(PH) patient
བཟོད-མ-བདེ-བ	(PH) intolerable
བཟོད-པ-དང-ལྡན-པ	(PH) patient
བཟུངས-འགོ	(PH) starting
ཆ	 (PH) even number; part; factor; [all] parts; all together; whole [as suffix]|(PH) even number; part; factor; [all] parts; all together; whole [as suffix] 
ཆ-བརྒྱད-སྐུ-གདུང	(PH) eight sets of relics
ཆ-ལང	(PH) cymbals
ཆ-མ-ཚང	(PH) incomplete
ཆ-ཚང	(PH) complete; entire 
ཆ-ཚང-བ	(PH) complete; entire 
ཆ-ཚང-ཁྱེར-བདེ	(PH) simple and complete
ཆབ	(PH) [honorific prefix particle]
ཆབ-ཤོག	(PH) official letter
ཆབ-སྲིད	(PH) kingdom; dominion; territory; [religious and secular] government; political affairs
ཆད-མལ	(PH) written agreement
ཆད-མོལ	(PH) written agreement
ཆད-པ	(PH) descendant
ཆག-ཉམས-སྐོང-བའི-ཚོགས-འཁོར	(PH) gaṇacakra feast for mending breaches
ཆགས-འབྲེལ	(PH) love affair
ཆགས-སྡང-རྨོངས-གསུམ	(PH) the three — attachment; aversion; and delusion
ཆགས-ཚུལ	(PH) origin
ཆལ-པ	(PH) scattering; covering
ཆར	(PH) rain; all; together
ཆས	(PH) clothes
ཆེ-ཆུང-སྐོར-གཉིས	(PH) two groups — greater and lesser
ཆེད	(PH) for the sake (of); in order that
ཆེད-དུ	(PH) for the sake (of); in order that
ཆེན-མ	(PH) senior queen; elder woman
ཆེན-མཆོག	(PH) supremely precious
ཆེན-པོ-སྐོར-བཞི	(PH) the four greater cycles
ཆེན-པོ-སྐོར-གསུམ	(PH) the three greater cycles
ཆེན-པོའི-ཆེན-པོ	(PH) the great of the great
ཆེར-བླུན-པ-ཉིད	(PH) extreme stupidity
ཆེས-དཔའ	(PH) great hero
ཆེས-སྐྱེན-པར	(PH) correctly
ཆེས-སྔ	(PH) previous
ཆེས-སྔ-བ	(PH) previous
ཆེས-སྔ-བར	(PH) previously
ཆེས-ཟབ	(PH) exceptionally profound
ཆིབས	(PH) mount [horse; etc.] (h)
ཆོ-ག	(PH) ritual
ཆོག-པ	(PH) ritual; permissible
ཆོས	(PH) Dharma; teachings; quality; profound; deep
ཆོས-འབྱུང-གི-ཕྱག-རྒྱ	(PH) seal of the origin of phenomena (dharmodaya-mudrā)
ཆོས-འཆད-པའི-ཕྱག-རྒྱ	(PH) Mudra of Explaining the Dharma
ཆོས-འཆད-ཕྱག-རྒྱ	(PH) Mudra of Explaining the Dharma
ཆོས-འཕགས	(PH) [Bodhisattva] Dharmodgata
ཆོས-བདག-མེད-པ-ཉིད	(PH) selflessness of phenomena
ཆོས-བཟོད-བཞི	(PH) four doctrinal forbearances
ཆོས-དང-ཆོས-མ-ཡིན-པའི-ལས	(PH) virtuous or non-virtuous karma
ཆོས-དྲན-པ-ཉེ-བར-གཞག-པ	(PH) application of mindfulness based on phenomena
ཆོས-གོས	(PH) religious robe; outer robe
ཆོས-ཀུན-གྱི-ཡུལ-ཅན	(PH) subject [that cognizes] all phenomena
ཆོས-ཀྱི-འབངས	(PH) Dharmadasa
ཆོས-ཀྱི-གྲྭ	(PH) religious center; religious college; doctrinal college
ཆོས-ཀྱིས-འཕགས-པ	(PH) [Bodhisattva] Dharmodgata
ཆོས-མིན-གྱི-བསམ-སྦྱོར	(PH) thoughts and actions contrary to the Dharma
ཆོས-མིན-པ	(PH) non-virtue
ཆོས-སེམས-ཅན	(PH) religiously-minded [person]
ཆོས-སྐུ-ཉག-གཅིག	(PH) unique dharmakaya
ཆོས-སྐུ-རྐྱང	(PH) Dharmakaya alone
ཆོས-ཟབ-མོ-སྟོང-པ-ཉིད	(PH) emptiness; the profound doctrine
ཆུ	(PH) water
ཆུ-བུར-ཅན	(PH) those in the Blistering Hell [the first cold hell]
ཆུ-དག	(PH) water
ཆུ-ཀླུང	(PH) river; waterfall
ཆུ-སྐྱེས	(PH) lotus (lit. 'water-born')
ཆུ-སྟོད	(PH) Purvasadha [one of twenty-eight constellations]
ཆུ-སྟོད-ཟླ-བ	(PH) sixth month
ཆུང-ངུ-སྐོར-གསུམ	(PH) the three lesser cycles
ཅི-བས-ཀྱང	(PH) very much; especially
ཅི-བསམ-ཀུན-འགྲུབ	(PH) all your wishes will be fulfilled
ཅི-ནུས-སུ	(PH) as much as possible; as many [times] as possible
ཅི-རིགས-པར	(PH) as is suitable; as either
ཅི-རིགས-སྒོ-ནས	(PH) from the point of view of whichever is suitable
ཅི-རིགས-སུ	(PH) suitably
ཅི-སྟེ	(PH) perhaps
ཅི-ཡང	(PH) at all; anything whatsoever
ཅིའུ-མཁར	(PH) prefectural capital
ཅིག	(PH) [imperative marker]
ཅིག-ཤོས	(PH) other one
ཅོ-འདྲི	(PH) injurious
ཅོད-པན	(PH) crown
ཅུང	(PH) slight
ཅུང-མི-བདེན	(PH) somewhat untrue
ཅུང-ཟད	(PH) slightest; slightly
དད-པ-ཅན	(PH) faithful
དད-རྟེན	(PH) relics
དད-སྟོབས	(PH) great faith
དག-ཆེ-བ	(PH) great purity; exceptionally pure
དག-གོས	(PH) metal garment
དག-པ-རབ-འབྱམས	(PH) all-encompassing purity
དག-པའི-གོས	(PH) metal garment
དག-སྒྲིག-པ	(PH) editor
དལ-འབྱོར-བཅོ-བརྒྱད	(PH) eighteen leisures and fortunes
དལ-འབྱོར-རྟེན	(PH) leisure and fortune
དལ-བརྒྱད-འབྱོར-བཅུ	(PH) eight leisures and ten fortunes
དལ-གྱིས-འབབ	(PH) Mandākinī [Lake]
དལ-ཡམས	(PH) plague; epidemic
དམ	(PH) excellent; holy; promise; vow
དམ-བཅའ-རྣལ-མ	(PH) genuine thesis
དམ-བཅའ-ཙམ	(PH) mere thesis
དམ-པ-མིན	(PH) inappropriate; unseemly
དམ-པ-ཡིན-པ་	(PH) being excellence
དམ-པའི-ཆོས-དྲན-པ-ཉེ-བར-གཞག-པ	(PH) Application of Mindfulness of the True Dharma [Sūtra]
དམ-པའི-ལེགས-བཤད	(PH) good explanations of excellent [beings]
དམ-ཚིག	(PH) commitment; pledge
དམ-ཚིག-ཅན	(PH) holder of commitments
དམ-ཚིག-དཔའ	(PH) samayasattva
དམ-ཚིག-པ	(PH) holder of commitments [e.g. a tantric practitioner]
དམ-ཚིག-ཕྱག-རྒྱ	(PH) commitment-seal
དམ-ཚིག-རྣམ-དག-པ	(PH) pure commitments
དམ-ཚིག-སེམས-དཔའ	(PH) samayasattva; commitment-being
དམ-ཚིག-སྒྲོལ-མ	(PH) Samaya Tara
དམ-ཚིག-སློབ-དཔོན	(PH) commitment-master
དང-པོ-བཞི	(PH) the first four
དང-པོ-གསུམ	(PH) the first three
དང-པོ-ལྔ	(PH) the first five
དང-པོ-ཉིད	(PH) the very first
དར	(PH) silk
དར-བ	(PH) whole plant
དར-གྱི-ན-བཟའ	(PH) silk clothing
དར-ཡོལ	(PH) adulthood
དབའ-རླབས	(PH) billowing waves
དབང-འབྲིང	(PH) middling faculties
དབང-ཕྱུག-ནག-པོ	(PH) Īśvarakṛṣṇa
དབང-པོ	(PH) organs; Indra
དབང-པོའི-མངོན-སུམ-ཚད-མ	(PH) valid sense perception
དབང-པོའི-ཐོག	(PH) Indraketu [p.n. of a tathāgata]
དབང-ཤེས-འཁོར-གྱི-སེམས-བྱུང	(PH) mental factors accompanying a sense consciousness
དབར	(PH) between [Amdo dialect]
དབོན	(PH) grandson
དབོན-མ	(PH) grand-daughter
དབོན-སྲས	(PH) grandson
དབོན-ཞང	(PH) son-in-law
དབུ-བ	(PH) foam
དབུ-བའི-གོང-བུ	(PH) ball of foam
དབུ-ཤོག	(PH) initial page; opening page
དབུ-སྙུང	(PH) oath on one's head
དབུག-གུ	(PH) half-hour ("extended breath") [25 minutes]
དབུགས-མི-བདེ	(PH) asthma
དབུགས-རླུང	(PH) breath-wind
དབུལ-བ-ཀུན	(PH) extreme poverty
དབུལ-བོ	(PH) starving
དབུལ-ཕོངས-ཀུན	(PH) extreme poverty
དབུས-བ	(PH) central
དབུས-རུ	(PH) district of Ü [n. of one of two districts of central Tibet (dbus)]
དབྱངས	(PH) voice; speech
དབྱངས-གསལ	(PH) vowels and consonants
དབྱངས-ཀྱི-ཡན-ལག-དྲུག-ཅུ	(PH) sixty types of melodies
དབྱངས-རྣ-སྙན-པོ	(PH) melody; melodious song
དབྱངས-རྟ-སྙན-པོ	(PH) melody; melodious song
དབྱངས-སྙན	(PH) melody; melodious song
དབྱངས-སྙན-པ	(PH) melody; melodious song
དབྱར-གྱི-རྔ	(PH) drums of thunder; dragon's voice
དབྱར-རྔ	(PH) drums of thunder; dragon's voice
དབྱིག	(PH) precious resources
དབྱིག-འཛིན	(PH) treasure-bearing [realm]; Vasundhara ("Bearer of Treasure") [epithet of the earth]
དབྱིག-གི-སྙིང-པོ	(PH) Hiraṇyagarbha (Brahmā)
དབྱུག-སྔོན-ཅན	(PH) Nīladaṇḍa
དེ	(PH) [continuative syntactic particle]
དེ-བཞིན-འཛིན-པ	(PH) retention
དེ-བཞིན-ཉིད	(PH) thusness
དེ-བཞིན-ཏུ	(PH) similarly
དེ-དུས-ཙ-ན	(PH) at that time
དེ-གཉིས-གང-རུང-མ-ཡིན-པ	(PH) being neither of those two
དེ-གཉིས-སུ-གྲངས-པ	(PH) enumeration as these two
དེ-ཁ	(PH) exactly that; that very same
དེ-ལྟ	(PH) such; just; exactly; just so
དེ-ལྟ-ན-ཡང	(PH) in that case; moreover
དེ-ལྟས	(PH) therefore
དེ-མ-ཐག-པའི-ཏིང-ངེ-འཛིན	(PH) an immediately preceding meditative stabilization
དེ-ཉིད	 (PH) reality; suchness | (PH) that very [thing]; just that itself|(PH) principle 
དེ-ཉིད-བསྡུས-པ	(PH) Compendium of the Suchness of All the Tathāgatas Tantra (sarva-tathāgata-tattva-saṁgraha tantra)
དེ-ཉིད-གསུམ-གྱི-བསམ-གཏན	(PH) concentration of the three principles
དེ-ས-དུ	(PH) what particular stage
དེ-སྙེད-ཅིག	(PH) just how many; just how much
དེ-ཙ-ན	(PH) at that time
དེ-ཙམ	(PH) subtle object
དེ-ཙམ-ན	(PH) about that time
དེའི-གནས-སྐབས-སུ	(PH) on this occasion
དེའི-མཇུག-ཐོགས-སུ	(PH) immediately after this
དེའི-ཕྱོགས-གཅིག-ཉོན-སྒྲིབ-ཀུན-བཏགས	(PH) the artificial afflictive obstructions which are one part of [the afflictive obstructions]
དེའི-རིང	(PH) now
དེའི-ས-དུ	(PH) what particular stage
དེའི-སྐད-ཅིག-གཉིས-པ-ལ	(PH) in the next period
དེབ-སྔོན-པ	(PH) Blue Annals
དེད-དཔོན	(PH) captain; chief; guide
དེང	(PH) now; presently
དེང-ནས	(PH) from just that point on; from now on
དེང-སང	(PH) these days; nowadays
དགའ-བ-ཁྱད-པར-ཅན	(PH) a special joy
དགའ-བོ	(PH) Nanda (p.n. of a monk during the time of the Buddha)
དགའ-ལྡན	(PH) Tuṣita ["Joyous," fourth of the six Desire Realm Heavens]; Ganden Monastic University [one of the three large monastic universities in Lhasa/Mundgod]; Ganden [Government]
དགའ-མགུ	(PH) immense joy
དགའ-སྟོན	(PH) festival; party
དགག-བྱ-བཀག-པའི-མེད-འགག	(PH) non-affirming negation that is the negation of the object of negation
དགེ-འདུན-རྗེས-སུ-དྲན-པ	(PH) mindfulness of the Sangha
དགེ-འདུན-ཞལ-གྲངས	(PH) census of the saṅgha; head-count of the saṅgha
དགེ-བའི-བཤེས-གཉེན	(PH) virtuous friend; spiritual guide
དགེ-བའི-གཉིད	(PH) virtuous sleep
དགེ-བའི-སེམས	(PH) virtuous state of mind
དགེ-བའི-སེམས-བྱུང	(PH) virtuous mental factors
དགེ-བའི-སེམས-བྱུང-བཅུ-གཅིག	(PH) eleven virtuous mental factors
དགེ-མཚན	(PH) virtuous signs
དགེ-རྩ-ཆད-པའི-མྱང-འདས	(PH) [nirvāṇa which is] a passing beyond the sorrow of the severance of virtuous roots
དགེ-རྩ-ཅི-རིགས	(PH) whatsoever roots of virtue
དགེ-སེམས-ཁྱད-པར-ཅན	(PH) especially virtuous state of mind
དགེ-སློང	(PH) mendicant
དགེ-སློང-མའི-བསླབ-བྱ	(PH) monastic rules for nuns
དགེ-ཚུལ-བསླབ-པའི-གཞི-མདོ	(PH) Sūtra of the Basic Points of Novice Monastic Training (śikṣapada-sūtra)
དགེ-ཚུལ-གྱི-བསླབ-པའི-གཞིའི-མདོ	(PH) Sūtra of the Basic Points of Novice Monastic Training (śikṣapada-sūtra)
དགེ-ཚུལ-གྱི-ཕྱིར-བཅོས	(PH) Buddhist monastic discipline for a novice
དགེ-ཚུལ-གྱི-སློབ-དཔོན	(PH) novice preceptor
དགོན	 (PH) wilderness|(PH) lord 
དགོན-པའི-ཐིག-ལེ	(PH) "Drop of wilderness" [n. of a tree]
དགོན-རྙིང	(PH) ancient monastery
དགོངས-པའི-སྐད	(PH) implied speech
དགོས-པ-ཆུང	(PH) minor consideration
དགུན-ཆུང	(PH) late-winter [season]
དགུན-སྒང	(PH) period of winter
དགུང-གྲངས	(PH) age (hon.)
དགུང-སྤར	(PH) trigram
དཀའ-བཅུ-པ	(PH) "Master of the Ten Difficult Texts" (dka' bcu pa)
དཀའ-ཟློག	(PH) ascetic
དཀའ-ཟློག-དད	(PH) devotee of Durgā
དཀར-དམར-མདངས-གསལ	(PH) clear white complexion with a tinge of red
དཀར-གསལ	(PH) radiant white
དཁྱིལ-འཁོར-ཡོངས-རྫོགས	(PH) the complete maṇḍala
དཀོན-མཆོག-གི-སྤྲིན	(PH) Cloud of Jewels [Sūtra]
དཀོན-མཆོག-གསུམ	(PH) Three Jewels
དཀོན-མཆོག-རིན-ཆེན-གསུམ	(PH) Three Precious Jewels
དཀོན-མཆོག-རྗེས-དྲན	(PH) Sutra on the Recollection of the Three Jewels
དཀོན-མཆོག-སྤྲིན	(PH) Cloud of Jewels [Sūtra]
དཀོན-མཆོག-སྤྲིན-གྱི-མདོ	(PH) Cloud of Jewels Sūtra
དཀུ-གཙང	(PH) confidence
དཀྱུས	(PH) section; separate section
དཀྱུས-བཏགས	(PH) kha-ta (scarf) of ordinary quality
དམའ-མོ	(PH) lowly people
དམག	(PH) war; battle
དམག-འདྲེན	(PH) leading to war
དམག-བརྒྱ-བ	(PH) Śatānīka [a Licchavi]
དམན-པའི-ས-དང-པོ-བདུན	(PH) the first seven Lesser Vehicle grounds
དམངས-སྒྲུང	(PH) folk tale; folkstory
དམར-པོ-རི	(PH) Red Hill [in Lhasa] (present site of the Potala Palace)
དམར-སེར	(PH) orange; reddish-yellow
དམར-ཤལ-གྱི-རིམས	(PH) bloody pox
དམར-སྔོན	(PH) red and blue
དམིགས-པ-ཆེ-བ-ཉིད	(PH) greatness of object of observation
དམིགས-པ-མེད-པ	(PH) without reservation
དམིགས-རྣམ	(PH) object of observation and [subjective] aspect
དམིགས-སུ-མེད-པ	(PH) unapprehendability; unobservability
དམྱལ-རྩུབ	(PH) rough hell
དངོས-བརྒྱུད	(PH) actual and of the lineage
དངོས-བརྒྱུད-ཅི-རིགས-པའི-སྒོ-ནས	(PH) directly or indirectly as is suitable
དངོས-དབང	(PH) the power of the thing
དངོས-གྲུབ-ཐུན-མོང	(PH) common siddhis
དངོས-གཞི	(PH) main part
དངོས-གཞི-ཁྱད-པར-ཅན	(PH) special main part
དངོས-པོའི-གནས-ཚུལ	(PH) mode of subsistence of things
དངོས-པོའི-ལྷན-ཅིག-བྱེད-རྐྱེན	(PH) cooperating condition of functioning thing
དངོས-སམ-བརྒྱུད-པའི-སྒོ-ནས	(PH) directly or indirectly
དངོས-སྟོབས-ཀྱིས-བསལ-བ	(PH) factual exclusion
དངོས-སུ-བསྐྱེད-བྱ	(PH) that which is directly produced
དོ	(PH) some portion (of); approximately; roughly; [prefix suggesting approximation]; equal; match; equivalent; (arch.) two
དོ-གལ	 (PH) importance; weight|(PH) force; power 
དོན-དམ-པ	(PH) ultimate
དོན-དྲན	(PH) memorandum
དོན-གཉེར-བ	(PH) one who is attentive
དོན-གྱི-བྱ-བ	(PH) attending to [someone's] needs
དོན-གཞན	(PH) different affair; factually other
དོན-མི-གཅིག	(PH) not synonomous
དོན-མཐུན	(PH) [one of] similar purpose
དོན-སྒྲ-ཇི-བཞིན-མ-ཡིན-པ	(PH) non-literal meaning
དོན-སྤྱི	(PH) object universal; meaning generality
དོན-སྤྱིའི-གསལ-སྣང	(PH) the clear appearance of a meaning generality
དོན-སྤྱིའི-གསལ-སྣང-གི-ཏིང-ངེ-འཛིན	(PH) meditative stabilization of the clear appearance of a meaning generality
དོན-སྤྱིའི-སྣང-བ-མཆེད-པའི-ཏིང-ངེ-འཛིན	(PH) meditative stabilization of the increase of appearance [this appearance being] of a meaning generality
དོང	(PH) walk; journey
དཔའ	(PH) hero
དཔའ-བོ	(PH) hero; intrepid person
དཔག-མེད-རིང-བ	(PH) immeasurably long
དཔལ	(PH) ensignia; banner
དཔལ-བེའུ	(PH) endless knot
དཔལ-བརྩེགས-རྒྱལ-པོ	(PH) Śrīkūṭa-rāja
དཔལ-བསམ-ཡས-ལྷུན-གྱིས-གྲུབ-པ	(PH) Samye Hlun-gyi-drup-pa [Temple] ("spontaneous fulfillment of limitless aspirations")
དཔལ-གྱི-བསམ-ཡས-ལྷུན-གྱིས-གྲུབ-པ	(PH) Samye Hlun-gyi-drup-pa [Temple] ("spontaneous fulfillment of limitless aspirations")
དཔལ-མགྲིན	(PH) Śrīkaṇṭha
དཔལ-ནག-པོ	(PH) Śrī Kṛṣṇa
དཔང-སྐོང-ཕྱག-བརྒྱ-པ	(PH) "One Hundred Homages for Mending Transgressions" (D 267)
དཔར	(PH) page
དཔེ-བྲིས-མ	(PH) manuscript
དཔེ-ལྡེབ	(PH) book
དཔེ-མ	(PH) exemplary
དཔེ-མཛོད-པ	(PH) librarian
དཔེ-ཉེར-འཇལ-གྱི-རྗེས-དཔག	(PH) inference through example; inference through analogy
དཔེ-རྫི	(PH) index; register
དཔེ-རིང	(PH) long folio; long text
དཔེ-རིས	(PH) diagram
དཔེ-ཐུང	(PH) short folio
དཔེའི-འོད-གསལ	(PH) metaphoric clear light
དཔོན-པོ	(PH) headman; chief
དཔུང-གི-ཚོགས	(PH) armies; forces
དཔུང-ཚོགས	(PH) armies; forces
དཔྱ	(PH) tax; rent
དཔྱ-བ	(PH) tax; rent
དཔྱད-གཞི	(PH) reference; data
དཔྱིད	(PH) spring; springtime
དཔྱིད-དཔལ	(PH) glory of springtime
དཔྱིད-དུས	(PH) spring; springtime
དཔྱིད-ཀ	(PH) spring; springtime
དཔྱིད-ཀའི-དུས	(PH) spring; springtime
དཔྱིད-ཟླར-པ	(PH) [first month of Spring]
དཔྱིས	(PH) finally
དྲ-རྒྱ-ཆེན	(PH) greatly progressing
དྲག-པོ	(PH) fierce; sharp
དྲག-སྤྱོད	(PH) forceful action
དྲན-དང-ཤེས-བཞིན	(PH) mindfulness and introspection
དྲན-པ-བཅུ	(PH) ten mindfulnesses
དྲན-པ-ཉེ-བར-གཞག-པ	(PH) application of mindfulness
དྲན-པ-ཉེ-བར-གཞག-པ-བཞི	(PH) four applications of mindfulness
དྲན-པ-ཉེར-གཞག	(PH) applications of mindfulness; Applications of Mindfulness [Sūtra]
དྲང	(PH) straight-forward; forthright
དྲང-པོའི-ལུགས	(PH) straight-forward manner; honest approach
དྲང-སྲོང-གཟེགས-ཟན	(PH) the sage Kaṇāda
དྲང-སྲོང-ལྷུང-བ	(PH) Ṛṣipatana (near Varanasi)
དྲང-སྲོང-རྒྱས-པ	(PH) the ṛṣi Vyāsa
དྲང-སྲོང-སྨྲ-བ-རི-དྭགས-ཀྱི-ནགས	(PH) Deer Park at Ṛṣipatana
དྲང-ཐད-དུ	(PH) straightforward
དྲེལ	(PH) mule
དྲི	(PH) odor
དྲི-འཚོར-བ	(PH) olfactory sensation
དྲི-ཆུའི-ལམ	(PH) urinary tract
དྲི-མ	(PH) stain; taint; defilement
དྲི-ང	(PH) foul-smell
དྲིན-ཅན-རྗེ	(PH) kind lord
དྲིན-དུ-ཆེ	(PH) very kind
དྲིན-དུ-མི-ཆེ	(PH) not very kind
དྲོད	(PH) [bodily] warmth
དྲོན	(PH) hot; warm
དྲུག-ཅུའི-དབྱངས	(PH) sixty [types of] melodies
དྲུག-ཅུའི-དབྱངས-ལྡན	(PH) endowed with the sixty [types of] melodies
དྲུག-མ	(PH) the six; all six
དྲུང-རིགས	(PH) secretariat
དྲུང-རྩིས	(PH) secretary and finance minister (drung yig dang rtsis dpon)
དྲུང-ཡིག-ཆེན-མོ	(PH) secretary-general (2nd rank)
དྲྭ-བ	(PH) net; network
དུ-མ-ཞིག	(PH) many; manifold
དུ-ཤེས-གཡེར-པོ	(PH) determinative discrimination
དུད-ཁུང	(PH) chimney
དུá¸¥-ཁ-མེད-པ	(PH) one who is without suffering
དུམ-བུ-དུམ-བུ	(PH) sections; pieces
དུར-འཁྲོད	(PH) charnal ground; sky burial site
དུར-ཁྲོད-ཀྱི-མེ	(PH) charnal (śmaśāna) fire
དུར-ཁྲོད-ཀྱི-རས	(PH) charnel ground cloth
དུར-ཁྲོད-པ	(PH) one who lives in a charnal ground
དུས-ཀྱི-འཁོར-ལོ	(PH) Kālacakra; Kālacakra [Tantra]
དུས-ཀྱི-རྒུད-པ	(PH) Unfortunate Era
དུས-རིང-དུ	(PH) for a long time
དྭོགས-ཟོན	(PH) caution
ཛམབུ-གླིང	(PH) Jambudvipa
ཛེ-ཏཱ-རི	(PH) Jetāri
ཛིང-གིན	(PH) Ghingis Khan
ཨེ-མ	(PH) O!; Ah!; Alas!
གཡའ	(PH) dust; dirt; defilement; rocky cliffs
གཡས	(PH) counter-clockwise
གཡོ	(PH) dissimulation; deceit; deception
གཡོ-རུ	(PH) Yö-ru [n. of one of two districts of central Tibet (dbus)]
གཡོ-སྒྱུ	(PH) deceit and guile
ག	(PH) where (= ga la)
ག-ལ	(PH) how; where
ག-ཉ-ཛི-ར	(PH) spire
གང	(PH) anything; that; what
གང-འདུལ-སྤྲུལ-སྐུ	(PH) Emanation Body taming whoever [needs taming]
གང-འགྲུབ	(PH) however [many] can be done
གང-དང-གང	 (PH) each-and-every|(PH) back-and-forth 
གང-དེ	(PH) whatsoever
གང-ནས	(PH) at whatever [point]; from [whenever]
གང-རུང	(PH) either one of; whichever
གང-སུ-དག-འདི	(PH) whichsoever of these
གང-ཡང-རུང-བ-ཞིག	(PH) any single; any single [one]
གང-ཟག-བདག-འཛིན	(PH) conception of a self of persons
གང-ཟག-བདག-འཛིན-གཉིས	(PH) the two types of conception of a self of persons
གང-ཟག-གང	(PH) whatever person; whosoever
གང-ཟག-གི-བདག-འཛིན	(PH) conception of a self of persons
གང-ཟག-གི-བདག-མེད-ཕྲ-མོའི-རྣམ-པ-ཅན	(PH) having the aspect of the subtle selflessness of persons
གང-ཟག-གི-བདག-ཏུ-འཛིན-པའི-བློ	(PH) awareness that grasps at a self of persons
གང-ཟག-གི-བསམ-པ	(PH) attitudes of a person; thoughts of a person
གང-ཟག-གི-ལོངས-སྤྱད-བྱ	(PH) objects of enjoyment of a person
གང-ཟག-རང-རྐྱ-ཐུབ-པའི-རྫས-ཡོད	(PH) being substantially existent in the sense of being a self-sufficient person
གང-ཞིག-གང	(PH) anything whatsoever
གངས-ཅན-གྱི-ལྗོངས	(PH) Realm of Snow [Tibet]
གངས-ཅན-གྱི-ལྗོངས-ཆེན-པོ	(PH) Great Realm of Snow [Tibet]
གངས-ཅན-གྱི-ཡུལ	(PH) Land of Snow (Tibet)
གངས-ཅན-ལྗོངས	(PH) Realm of Snow [Tibet]
གངས-ཅན-མུན-པའི-སྨག-རུམ	(PH) the dense darkness of the Land of Snows
གངས-ལྗོངས	(PH) Realm of Snow [Tibet]
གངས-རིའི-ལྗོངས	(PH) Realm of Snowy Mountains [Tibet]
གར	(PH) dancing; dance
གར-ལོག	(PH) Garlok (a small kingdom in Nga-ri; western Tibet)
གཅམ-བུའི-ཚིག	(PH) flattering words
གཅེན-མོ	(PH) elder sister
གཅེན-མོ-དང-གཅུང-མོ	(PH) sisters (elder and younger)
གཅིག	(PH) identity; same
གཅིག-བཀག-པའི-ཐ-དད	(PH) a difference which is a negation of oneness
གཅིག-བུ-ཞིག	(PH) alone
གཅིག-མི-གཅིག	(PH) same or not the same
གཅིག-པ-བཀག-པ	(PH) merely not one
གཅིག-པུ	(PH) sole; lone; sole; single; alone
གཅིག-པུ-ཉིད་	(PH) solitary
གཅིག-པུར	(PH) alone; sole
གཅོད-བྱེད-ཀྱི-བུ	(PH) Vantāsikā (a class of pretas)
གཅོད-ཡུལ-པ	(PH) Chöd practitioner
གཅོམ	(PH) conceit
གཅོང-རོང	(PH) chasm
གཅོང-རོང-ཆུ	(PH) river running through a chasm
གཅོང-རོང-གི-ཆུ-བུ	(PH) river running through a chasm
གདགས-གཞིའི-ཚད-མ	(PH) valid basis of designation
གདན	(PH) seat; cushion
གདན-བཤམས-པ	(PH) prepared seat
གདེང-དྲོད	(PH) strong confidence
གདེངས	(PH) confidence
གདེངས-རྟགས	(PH) sure sign(s)
གདོད-ནས	(PH) from the beginning
གདོལ-པ-སྨྱིག-མཁན	(PH) founder of a lineage of the lowest of outcastes
གདོན	(PH) planet; planetary influences; malevolent spirit; evil spirit
གདོན-བགེགས-འབྱུང-པོ	(PH) evil obstructing spirits
གདུག-པ	(PH) poisonous; pernicious [entities]; evil ones
གདུག-རྩུབ-ཅན	(PH) terrifying
གདུག-སྦྲུལ	(PH) poisonous snake
གདུགས-དཀར-པོ	(PH) white umbrella
གདུལ-བ-འབྱུང-པོ	(PH) beings who are the trainees
གདུལ-བྱ-གཞན	(PH) other trainees
གདུང-བ-མེད-པ	(PH) Anavatapta
གདུང-རྒྱུད	(PH) descendant; heir; lineage of descent
གདུང-ཤུགས	(PH) strong devotion; intense longing
གདུང-ཤུགས-དྲག-པོ	(PH) strong devotion; intense longing
གེ-སར	(PH) flower bud
གི-གུ	(PH) "i" vowel mark; [name of vowel marker for 'i']
གླ-བ	(PH) musk deer
གླན-དེ-འཇོག-པ	(PH) resetting [the 3rd mental abiding (sems gnas)]
གླིང-བཞི-གླིང-ཕྲན-བཅུ-གཉིས	(PH) twelve major and minor continents
གླིང-བཞི-གླིང-ཕྲན-བརྒྱད	(PH) four major and eight minor temples
གླིང-བཞི-མ	(PH) four-sided; with four sides
གླིང-དང-གླིང-ཕྲན	(PH) [four] continents and [eight] minor continents
གླིང-གཡོག-གམ-གླིང-ཕྲན-བརྒྱད	(PH) eight attendant or minor continents
གླིང-ཕྲན	(PH) island; minor continent
གླིང-ཕྲན-བ-རྒྱད	(PH) eight minor continent
གླིང-ཕྲན-བརྒྱད	(PH) eight minor continent
གློ-བུར-དྲི-བྲལ-གྱི-མྱང-འདས	(PH) nirvana that is free from momentary defilement
གློ-བུར-གྱི-དྲི-མ	(PH) adventitious defilement
གློག-འགྱུ	(PH) flash of lightening
གློག-འགྱུ-བ	(PH) flash of lightening
གློག-གི-རྗེས-འགྲོ-བ	(PH) lightning-like
གནམ-གྱི-སྐར-མ	(PH) [p.n. of a brahmin who had faith in the buddha and was reviled for it]
གནས	(PH) critical point; topic; place; location; abode; sphere; category
གནས-དང-ཡུལ-གྱི-ཕྱག-རྒྱ	(PH) mudras of the places and countries
གནས-གྱུར	(PH) transformation
གནས-ལོགས-པ	(PH) separate place
གནས-ལུགས-མཐར-ཐུག	(PH) final mode of subsistence
གནས-མེད-དངོས-པོ	(PH) a thing lacking duration
གནས-མིན-གནས	(PH) unsuitable
གནས-རྩ	(PH) the stable nerve centers (nadi)
གནས-སྐབས	(PH) temporary; temporary state; occasion; opportunity; context; situation; condition
གནས-ཡུལ	(PH) [twenty-four] places and [thirty-two] countries
གནས-ཡུལ-དཔའ-བོ-མཁའ-འགྲོ	(PH) the dakas and dakinis of the sacred places and countries
གནས-ཡུལ-དྲུག-ཅུ-རྩ-བཞི	(PH) sixty-four sacred places and countries
གནས-ཡུལ-དུར-ཁྲོད	(PH) [twenty-four] places; [thirty-two] countries; and [eight] charnal grounds
གནོད	(PH) yakṣa; harmful spirits
གནོད-གནས	(PH) Jambhala
གནོད-པ	(PH) harm; harmful [effects]; damage
གནོད-པ-ཆེན-པོ	(PH) mahāyakṣa
གནོད-པར-བྱེད-པ	(PH) harmer; those who do harm
གནོད-སྦྱིན	(PH) yakṣa; possessing demon
གནོད-སྦྱིན-གངས-བཟང	(PH) [a type of yakṣa]
གནོད-སྦྱིན-མོ	(PH) yakṣiṇī; female possessing demon
གནོན-གཤིན	(PH) funeral ritual [for suppressing zombies]
གཉེན-པོ-ཀུན-ཏུ-སྤྱོད-པའི-སྟོབས	(PH) the power of the properly applied antidote
གཉི-ཀ-ལྟར-ཡང	 (PH) either way; in either case|(PH) either way; in either case 
གཉིད	(PH) sleep
གཉིད-མཚན-ཉིད-པ	(PH) actual sleep
གཉིས-གཉིས	(PH) two each
གཉིས-པ-ཤོས	(PH) the other of the two
གཉིས-སྐྱེས	(PH) birds ("twice born")
གཉིས-སྣང-ཅན-གྱི-ཤེས-པ	(PH) dualistic consciousness
གཉིས-སྟོང-གི-རྣམ-པ-ཅན	(PH) having the aspect of an emptiness of duality
གཉིས-སུ-གྲངས	(PH) enumeration as two
གཉོམ-པོ	(PH) moderate
གོ-ར	(PH) Qur'an
གོ-ཏན	(PH) Go-tan [Khan] (Mongolian Emperor)
གོའུ-ཤམབྷི	(PH) Kauśambi
གོག-ཡུལ	(PH) Wakhan (Afghanistan)
གོང-གསལ-ལྟར	(PH) as clarified above [in the text]
གོང-མ-གོང-མ	(PH) higher and higher
གོང-མའི-སྐྱེད-ཚལ	(PH) imperial garden
གོང-མའི-སྤྱི	(PH) vertical-universal
གོང-ས	(PH) His Holiness
གོས	(PH) cloth; clothes; clothing
གོས-ཆེན-རི-མོ	(PH) brocade designs
གོས-དག	(PH) clothes
གོས-ཐུམ	(PH) layer of cloth
གྲག	(PH) sound; noise
གྲག-པ	(PH) sound; noise
གྲག-སྟོང-དབྱེར-མེད	(PH) inseparability of being audible and yet empty
གྲགས-རྟགས-ཡང-དག	(PH) correct sign of renown
གྲལ	(PH) status; series; rank
གྲལ-འོག	(PH) end of a row
གྲལ-གཤམ	(PH) lower rank
གྲལ-མཐོ-ས	(PH) head of the row
གྲལ-རིམ	(PH) line sequence
གྲལ-རྐེད	(PH) middle rank
གྲལ-སྟོད	(PH) front rank
གྲང-བའི-ནད	(PH) rheumatism
གྲངས-ངེས-པ	(PH) definite in number
གྲངས-སྙེད	(PH) however many equal in number (to)
གྲས-མཚུངས-པ	(PH) order; orderly fashion
གྲིབ-པ-རྣམ-སེལ	(PH) Sarvanīvaraṇaviṣkambhin (p.n. of a bodhisattva)
གྲོ-གཅིག	(PH) one day's journey
གྲོ-ལྷུག	(PH) paunchy; chubby
གྲོ-ཤོད	(PH) Trochö [n. a district in Tibet]
གྲོག-མོ	(PH) ant
གྲོག-རོང	(PH) ravine; gorge
གྲོང-ཁྱེར-དཔེ-མེད	(PH) Anupamamahāpura (n. city in Kaśmir)
གྲུ	(PH) angle; corner
གྲུ-འཛིན	(PH) rudder
གྲུ-འཛིན-བདག-པོ	(PH) Lord of the Potala (Avalokiteśvara)
གྲུ-བོ	(PH) boat; ship
གྲུ-ཆེན	(PH) vessel; confines; interior
གྲུབ-བདེ-གཅིག-པ	(PH) sameness in establishment and abiding
གྲུབ-མཐའ-རྣམ-བཞི	(PH) four systems of [Buddhist] tenets
གྲུབ-པའི-ལྷ	(PH) god of magical accomplishment
གྲུབ-པའི-མཐའ-སྤྱི	(PH) general tenets
གྲྭ-གྱུ-སྒང-བྲག	(PH) [a Guru Rinpoche cave]
གསད-པར-བྱ-བ	(PH) the condemned; someone condemned
གསལ-འོད-ཟེར	(PH) radiant clear light
གསལ-བ	(PH) elucidations; instances; manifestations
གསལ-བའི-དབྱེ-བ	(PH) divisions of instances
གསལ-བྱེད	(PH) consonant
གསལ-མདངས	(PH) radiant
གསལ-མྱོང	(PH) clear experience
གསལ-རྫོགས-མཚན-དཔེ	(PH) vivid and complete major and minor marks [of a Buddha or Cakravartin]
གསལ-སྣང-གི-ཏིང-ངེ-འཛིན	(PH) meditative stabilization of clear appearance 
གསང-བ-དབང-བསྐུར	(PH) secret initiation
གསང-བ-ཤེས-རབ-དབང-བསྐུར	(PH) the secret and wisdom initiations
གསང-བའི-དུར-ཁྲོད-བརྒྱད	(PH) eight secret charnel grounds
གསང-གསུམ-རྒྱན	(PH) the ornaments of the three secrets [of body; speech; and mind]
གསར-བུ	(PH) novice
གསེག-མ	(PH) gravel; grit; pebbles; sugar
གསེག-སྒམ	(PH) leather box
གསེག-ཤུབས-མ	(PH) leather case
གསེར-མིག-ཅན	(PH) the golden-eyed one
གསེར-ཡིག-པ	(PH) envoy
གཤམ	(PH) bottom; underneath
གཤམ-གསལ-ལྟར	(PH) as clarified below [in the text]
གཤེ-བ-པོ	(PH) abusive person
གཤིན-རྗེ-དམར-ནག-གི-རྒྱུད	(PH) Raktayamari Tantra
གཤིས-དྲང	(PH) honest nature
གཤོག-རླབས	(PH) wing movement
གསོ-དཔྱད	(PH) medicinal treatment
གསོ-ཐབས	(PH) medical procedure
གསོད-གནས	(PH) place of execution
གསོལ-བ-འདེབས-པ	(PH) supplication
གསོལ-དཔོན	(PH) officer in charge of beverages
གསོལ-ལྷུང	(PH) alms bowl; begging bowl
གསོལ-ངན	(PH) bad food; poisonous food
གསོལ-རས	(PH) present; gift
གསུམ-འཛོམས	(PH) three abuundances [offerings of food; drink; and money]
གསུམ-གསུམ	(PH) three each
གསུང-བསལ-བའི-སྒྲ	(PH) a sound that clears away speech (?)
གསུང-ཆོས	(PH) teachings; religious instruction
གསུང-དབྱངས-ཡན-ལག-དྲུག-ཅུ	(PH) speech [with] sixty [types of] melodies
གསུང-ངག-རིན-པོ-ཆེ	(PH) "precious instruction" [epithet of Sakya "Path and Fruit" tradition]
གསུང-སྒྲོས	(PH) sayings; teachings; analects
གཏད	(PH) aim; purview
གཏད-པ	(PH) aim; purview
གཏད-རབས	(PH) hierarch
གཏད-རབས-བདུན	(PH) [first] seven hierarchs [in succession to Śākyamuni Buddha]
གཏད-རབས-ནག-པོ	(PH) the [fifth] hierarch *Kṛṣṇa/*Kāla
གཏད-རྒྱ	(PH) entrustment
གཏམ	(PH) instructions; proverb; story
གཏམ-གྱི-སྦྱོར-བ	(PH) rambling tales
གཏན	(PH) completely; final
གཏན-འདུན-གྱི-སྙིང-པོ	(PH) essence of final aspiration
གཏན-གྱི-འདུན-མ	(PH) final objective
གཏན-གྱི-དོན	(PH) final aim
གཏན-གྱི-མདུན-མ	(PH) final concern
གཏན-གྱི-སྐྱབས	(PH) final refuge
གཏན-ལ-དབབ-བྱ	(PH) that which is to be settled
གཏན-ལ-དབབ-བྱའི-གཙོ-བོ	(PH) overriding concern; principle objective to be settled
གཏི-མུག	(PH) obscuration; delusion
གཏིང	(PH) depths
གཏིང-མཐའ	(PH) depths
གཏོ-མཁན	(PH) skilled in healing
གཏོང-པོ	(PH) profligacy; extravagance
གཙོ	(PH) main
གཙོ-བོ	(PH) best; primordial substance
གཙོ-བོ-རྟག-པ	(PH) permanent principle
གཙོ-བོའི-དོན	 (PH) principle meaning|(PH) primary objective 
གཙོ-བོར-སྐྱེད-བྱེད	(PH) main producer
གཙོ-པོ	(PH) general principal [in Sāmkhya]
གཙུག-གི-ནོར-བུ	(PH) crown jewel
གཙུག-ལག	(PH) teachings
གཙུག-ནོར	(PH) crown jewel
གཙུག-ཏོར	(PH) headdress
གཙུག-ཏོར-རྣམ-པར-རྒྱལ-མ	(PH) Usnisavijaya
གཏུམ-མོ-ཕལ-པ	(PH) ordinary inner heat
གུ-རུ-ཡིད-བཞིན-ནོར-བུ	(PH) Guru Chintamani (a form of Padmakara)
གུག-ཀྱེད	(PH) vocalic ornaments
གུག-སྐྱེད	(PH) vocalic ornaments
གུག-སྐྱེས	(PH) vocalic ornaments
གུང	 (PH) midnight|(PH) middle; center 
གུཔཏའི-སྐབས	(PH) Gupta-style
གུར-ཁྱིམ	(PH) mansion [under] a tent; abode
གུར-ཀུམ-མདངས-ལྡན	(PH) saffron colored
གུས-པ-ཆེན-པོ	(PH) great devotion
གུས-པའི-ཕྱག	(PH) respectful homage
གྱ-གྱུ-བ	(PH) dishonesty
གྱད-བུ-ནོར	(PH) Dravya Mallaputra (an arhat)
གྱར	(PH) fragment
གཟེགས-ཟན	(PH) Kaṇāda
གཟེངས-རིང	(PH) point; pointy
གཟེར	(PH) pain
གཞན-འཕྲུལ-དབང-བྱེད	(PH) [Heaven of] Controlling Others' Emanations (sixth of the six Desire Realm Heavens)
གཞན-གྱི-དབང-གི-མཚན-ཉིད	(PH) other-powered nature
གཞན-གྱི-དབང-གི-ངོ-བོ-ཉིད	(PH) entityness of the other-powered (nature)
གཞན-གྱིས-མི-ཐུབ-པ	(PH) Aparajita
གཞན-ལས-ངེས	(PH) [valid cognition for which] ascertainment induced by another
གཞན-ངོ	(PH) another's perspective
གཞས	(PH) play; folk song
གཞི	(PH) basis; referent; [writing] surface; bark
གཞི-དུས-ཀྱི-བྱ-གྲུབ-ཡེ-ཤེས	(PH) basic wisdom of achieving activities
གཞི-དུས-ཀྱི-མེ-ལོང-ཡེ-ཤེས	(PH) basic mirror-like wisdom
གཞི-དུས-ཀྱི-སོར-རྟོག-ཡེ-ཤེས	(PH) basic wisdom of individual investigation
གཞི-དུས-ཀྱི-ཡེ-ཤེས	(PH) basic wisdom
གཞི-དུས-མཉམ-ཉིད-ཡེ-ཤེས	(PH) basic equalizing wisdom
གཞི-དུས-སོར-རྟོག-ཡེ-ཤེས	(PH) basic wisdom of individual investigation
གཞི-གྲུབ	(PH) established base
གཞི-གྲུབ-པ	(PH) being an established base
གཞི-ཇི-བཞིན-པ	(PH) literal basis; actual base
གཞི-ཁ	(PH) district officer
གཞི-ལམ-འབྲས-གསུམ	(PH) the three: bases; paths; and fruits
གཞི-རྟེན	(PH) basis; foundation
གཞིའི-དོན	(PH) objective referent
གཞོག-གཟེར	(PH) pain in the sides of the chest
གཞོགས	(PH) side of the body
གཞོགས-གཟེར	(PH) pain in the sides of the chest
གཞོམ-མེད	(PH) unconquerable; invincible
གཞོན	(PH) young
གཞོན-ནུ	(PH) young
གཞོན-ནུ-ནོར-བཟང	(PH) Kumāra Sudhana
གཞུང	(PH) government; lengthwise
གཞུང-བཟང	(PH) good character
གཞུང-ལུགས-པ	(PH) follower of the textual system(s)
གཞུང-ཚད	(PH) length of the text
གཟི	(PH) radiance
གཟི-བརྗིད-ཆེན-པོ	(PH) endowed with majesty
གཟི-བརྗིད-ཆུང-ངུ	(PH) little splendor
གཟིག-ལྤགས	(PH) leopard skin
གཟིགས-དཔེ	(PH) books that were read
གཟིམ-མལ	(PH) (hon.) bed
གཟིམས-དཔོན	(PH) official in charge of dressing and bedding (3rd rank); chamberlain
གཟོ-བ	(PH) one who remembers
གཟོད-བསྒོམ-པ	(PH) primordial meditative state
གཟོད-ནས	(PH) from the beginning
གཟུགས-ཅན-སྙིང-པོ	(PH) [King] Bimbisāra
གཟུགས-གཟུགས-ཞེས-པའི-སྒྲའི-འཇུག-གཞི	(PH) form's being the basis for affixing the term "form"
གཟུགས-ཀྱི-སྐྱེ-མཆེད	(PH) form sense-sphere
གཟུགས-མཛེས	(PH) beautiful form
གཟུགས-མཚན-ཉིད-པ	(PH) fully qualified form
གཟུགས-རགས-པ	(PH) gross form
གཟུང-རྟོག	(PH) conception of the true existence of objects
གཟུར-གནས	(PH) unbiased
གཟུར-གནས-སྐྱེ-བོ	(PH) an unbiased being
ཧ-ཅང-ཐལ-བར-འགྱུར	(PH) absurd consequence
ཧ-ལ-ཧ-ལ	(PH) poison; poisonous plant
ཧཱ-ཤང	(PH) [Chinese Chan master] Ha-shang
ཧན-ལྡང	(PH) dumb; mute
ཧར-གྱི-གཏམ	(PH) empty talk
ཧོར	 (PH) Mongolia|(PH) Mongol 
ཧོར-དམག	(PH) Mongolian army; Mongolian soldiers
ཧྲང	(PH) single
ཧྲིག-ཧྲིག-པོ	(PH) wide-eyed
ཧཱུཾ-ཡིག	(PH) the letter HŪṂ
ཨིནདྲ-ནི-ལ	(PH) sapphire
ཇི-བཞིན	(PH) just as; like; as; correctly; properly
ཇི-བཞིན-དུ	(PH) just as; like; as
ཇི-བཞིན-མིན-པ	(PH) not like; unlike
ཇི-ལྟ-བ-ཇི-བཞིན-དུ	(PH) exactly; as it really is
ཇི-ཕྲ	(PH) accordingly subtle
ཇི-ཕྲ-ཇི-ཕྲ	(PH) each accordingly more subtle
ཇི-སྙེད	(PH) however much
ཇི-སྙེད-པ	(PH) however much
ཇི-སྙེད-པ-ཐམས-ཅད	(PH) all the varieties
ཇི-སྲིད-ཅིག-ན	(PH) for how long
ཇིང-གེར	(PH) Gengis Khan
ཇོ-བོ-རིན-པོ-ཆེ	(PH) Precious Jowo [Śākyamuni statue]
ཇོ-བཟང	(PH) good reputation; good repute
ཇོ-ལུགས-སྒྲོལ-དཀར	(PH) White Tara in Atiśa's lineage
ཀ	(PH) [verbal suffix meaning "about to"]
ཀ-བུམ-གཉིས	(PH) pillar and pot, the two
ཀ-ཅོག-ཞང	(PH) the three — Ka-wa [Pel-tsek (ka ba dpal brtsegs)]; Jok-ro [Lü-gyal-tsen (cog ro klu'i rgyal mtshan)]; and Zhang [Na-nam Ye-she-de (zhang sna nam ye shes sde)]
ཀ-དག	(PH) primordially pure
ཀ-ཙན-དབྱངས-གསུམ	(PH) three [core Sanskrit grammarians;] Kālāpa (Śarvavarman); Candragomin; and Anubhūti
ཀན-རྩ	(PH) pulse [felt with / under the middle finger]
ཀརཎ-པ	(PH) the people of Karṇāṭa
ཀས-གདུགས	(PH) canopy
ཀཽ-ཤི-ཀ	(PH) Kauśika [an epithet of Śakra]
ཁ	(PH) mouth; face; faction; division
ཁ-བ	(PH) snow; bitter
ཁ-བ-ཅན-གྱི-ཡུལ	(PH) Land of Snows (Tibet)
ཁ-བྱང	 (PH) label; index; register; introduction|(PH) [identifying] note 
ཁ-དོག-སྣ-ལྔ	(PH) variegated five-colored
ཁ-དྲང	(PH) straight-forward; forthright
ཁ-གསབ	(PH) everyday expressions
ཁ-གཏམ	(PH) oral tradition
ཁ-མདུན	(PH) forward
ཁ-མདུན-ངོས	(PH) facing forward
ཁ-ན-མ-ཐོ	(PH) unseemliness
ཁ-ན-མ-ཐོ-བ	(PH) unspeakable/unseemliness
ཁ-རྒྱབ	(PH) backward
ཁ-རྒྱབ-ངོས	(PH) facing backward
ཁ-སྟེང-དུ	(PH) upon; above
ཁ-ཐུར	(PH) downwards
ཁ-ཐུར-དུ	(PH) downwards
ཁ-ཞེང-ཆེ	(PH) vast and open
ཁབ	(PH) court; residence
ཁབ-དང-མེ-བཙའ	(PH) cauterization and moxibustion
ཁག	(PH) units; sections; types; parts
ཁམ-ཆེ-བ	(PH) great activity; great deed
ཁམ-ཆེས-བ	(PH) great activity; great deed
ཁམས	(PH) constituent; element; basic constituent; disposition; type; constitution; Kham [eastern province of Tibet]
ཁམས-ཆེན	(PH) major constituents
ཁམས-གོང-མ-གཉིས	(PH) two upper realms [Form and Formless]
ཁམས-གསུམ-གྱི-ས	(PH) the levels of the three realms
ཁམས-གསུམ-སྣོད-བཅུད	(PH) environment and [its] inhabitants of the three realms
ཁམས-ཡན-ཆད	(PH) Kham and regions to the west
ཁང-པ-བཀྲ-བ	(PH) whitewashed house
ཁང-སྟེང	(PH) upper level of a house
ཁར-ཡས-ཁར-ཡས་	(PH) inexplicable numbers
ཁེབས-པ	(PH) affliction
ཁོ-ན	(PH) still
ཁོ-ནར	(PH) only
ཁོད-ཡངས-པོ	(PH) vast expanse
ཁོན-པ	(PH) anger; resentment
ཁོངས-ས	(PH) territory
ཁྲ-འབྲུག	(PH) Tren-druk [a temple in Yarlung built by Songtsen Gampo]
ཁྲ-འབྲུག-ལྷ-ཁང	(PH) Tren-druk Temple [in Yarlung built by Song-tsen-gam-po]
ཁྲེལ-ཡོད	(PH) embarrasment
ཁྲེལ-ཡོད-པ-དང-ངོ-ཚ	(PH) embarassment and modesty
ཁྲི	(PH) ten thousand
ཁྲི-བསྲོང-ལྡེའུ-བཙན	(PH) King Trisong Deutsen
ཁྲི-གདུགས	(PH) throne and canopy
ཁྲི-ལོ	(PH) enthronement year
ཁྲི-མཐོན-པོ	(PH) high throne
ཁྲི-རལ-པ-ཅན	(PH) King Ralpajen
ཁྲིད-སྐོར	(PH) myriarch [governorship]
ཁྲིམས-གཉིས	(PH) two [systems of] ethics (i.e. sūtra and tantra)
ཁྲོ-བོ-གཙུག-ཏོར-འཁོར-བསྒྱུར	(PH) Ulagriva-cakravarti
ཁྲོད	(PH) among; in the midst (of)
ཁྲོད-དུ	(PH) among; in the midst (of)
ཁྲོད-ན	(PH) among; in the midst (of)
ཁྲུས-མཁན-མོ	(PH) washer-woman
ཁུང	(PH) hole; cave; pit; root; panting; snorting; depths [of the heart]
ཁུང-ཙི	(PH) Confucius; Confucianism
ཁུངས	(PH) origin; source
ཁུར	(PH) burden
ཁུར-པོ	(PH) load; burden
ཁུར-པོ-བ	(PH) coolie; porter; load-carrier
ཁུར-རིན	(PH) wages for carrying a load
ཁྱབ-བྱེད	(PH) pervasive [wind]
ཁྱབ-པའི-རང-བཞིན	(PH) all-pervasive
ཁྱད-ཆོས	(PH) distinguishing feature
ཁྱད-ཆོས-ཆེ-བ	(PH) most significant distinguishing feature
ཁྱད-ཆོས-ཀྱི-གཙོ-བོ	(PH) main distinguishing feature
ཁྱད-གཞི-ཁྱད-ཆོས-སྦྱར-བ	(PH) associated substratum and distinguishing feature
ཁྱད-གཞིའི-གནད	(PH) qualified bases
ཁྱད-པར-ཅན	(PH) distinctive; special
ཁྱད-པར-ཅན་	(PH) distinctive; special
ཁྱད-པར-གྱི-ཆོས་	(PH) distinguishing feature
ཁྱེར-བདེ	(PH) convenient; simple
ཁྱེར-སོ	(PH) manner
ཁྱི-ཕག-གི-བརྟུལ-ཞུགས	(PH) yogic discipline of dogs and pigs
ཁྱི-སྨྱོན-པའི-དུག	(PH) rabies
ཁྱི-སོ	(PH) dog's tooth
ཁྱིམ-བདག-དཔལ-སྦྱིན	(PH) the householder; Śrīdatta
ཁྱོན	(PH) size; extent; expanse
ཁྱོན-ནས	(PH) thoroughly
ཀླད-ནད	(PH) headache
ཀློག	(PH) reading
ཀློག-ཐབས	(PH) pronunciation manual
ཀླུའི-རྩ-ཤེ-རབ	(PH) Nāgārjuna’s Fundamental Treatise on the Middle Way; Called "Wisdom"
ཀླུའི-རྩ-ཤེ-རབ-བྱེད	(PH) Nāgārjuna’s Fundamental Treatise on the Middle Way; Called "Wisdom" Chapter #
ཀོ	(PH) [emphatic particle]
ཀོའུ-ཤམ-བི	(PH) Kauśambi
ཀོང-ཆུ	(PH) Kong-po river
ཀུལ-ཀ-བྱེད-པའི-གནས	(PH) disputed place
ཀུན-འབྱུང-བདེན-པའི-ཁྱད-ཆོས-བཞི	(PH) four distinguishing features of the truth of the origination [of suffering]
ཀུན-འབྱུང-མཐོང-སྤང-ཉོན-མོངས-བཅུ	(PH) ten afflictions to be abandoned by the path of seeing [related to the Noble Truth of] Origins
ཀུན-འདུས-པ	(PH) compendium
ཀུན-འགྲོའི-ཚུལ	(PH) applicable to everything
ཀུན-བཏུས	(PH) [Asaṅga's] Compendium [of Manifest Knowledge] (Abhidharmasamuccaya)
ཀུན-བྱང	(PH) the thoroughly afflicted and the purified
ཀུན-བྱང-གི-འགྲིབ-འཕེལ	(PH) increase and decrease of the thoroughly afflicted and the purified
ཀུན-བྱེད-ལས-རླུང	(PH) all-creating wind of karmic action
ཀུན-བཟང	(PH) Samantabhadra [p.n. of a Bodhisattva]
ཀུན-བཟང་	 (PH) thoroughly good; magnificent|(PH) Samantabhadra 
ཀུན-བཟང-མཆོད-སྤྲིན	(PH) clouds of offerings [like those] of Samantabhadra
ཀུན-བཟང-རྡོ-རྗེ-འཆང-ཆེན	(PH) great Samantabhadra Vajradhara
ཀུན-བཟང-རྣམ-འཕྲུལ	(PH) magical display of Samantabhadra
ཀུན-ད	(PH) Jasmine
ཀུན-དགའ-ར-བ	(PH) vihāra; monastic complex
ཀུན-དགའ-ར-བ-ཕུན-སུམ-ཚོགས-པ	(PH) perfect garden
ཀུན-དགའ-རྭ-བ	(PH) personal altar
ཀུན-གསལ-ར-བ	(PH) shining enclosure (i.e. the sky)
ཀུན-གྱི-དབང-ཕྱུག	(PH) powerful lord of all [that exists]; powerful lord of all [samsara and nirvāṇa]
ཀུན-ཁྱབ-མུན-པ	(PH) all-pervading darkness
ཀུན-མཁྱེན-ཀུན-གཟིགས	(PH) all-knowing and all-seeing
ཀུན-ནས-ལྡང-བ	(PH) obsession
ཀུན-ནས-ཉོན-མོངས-དང-རྣམ-བྱང	(PH) thorough affliction and purification
ཀུན-ནས-ཉོན-མོངས-དང-རྣམ-བྱང-གཉིས	(PH) both the thoroughly afflicted and the purified
ཀུན-ནས-ཉོན-མོངས-པ-མེད-པར-ཡོངས-སུ-ལོངས-སྤྱོད-པ	(PH) unafflicted thorough enjoyment
ཀུན-ནས-ཉོན-མོངས-རྣམ-བྱང	(PH) thorough affliction and purification
ཀུན-ཉོན-དང-རྣམ-བྱང-ཐ-དད-མེད-པ	(PH) a non-difference of thoroughly afflicted phenomena and purified [phenomena]
ཀུན-སློང-བྱང-ཆུབ-སེམས	(PH) motivation to [attain highest] enlightenment
ཀུན-སྤྱོད-གཙང-བའི-དཔེ-བྱད	(PH) minor mark of pure proper conduct
ཀུན-ཏུ-བཟང	(PH) thoroughly good; thoroughly beneficial
ཀུན-ཏུ-བཟང-མོ	(PH) Samantabhadri
ཀུན-ཏུ-བཟང-པོ	(PH) Samantabhadra [p.n. of a Bodhisattva]
ཀུན-ཏུ-རྒྱལ	(PH) Saṃjaya
ཀུན-ཏུ-རྒྱུ-མོ	(PH) wandering female ascetic
ཀུན-ཏུ-སྤྱན-རས-གཟིགས-དབང-པོ	(PH) Avalokiteśvara
ཀྱི-ཧུད-ཨ-ཟ	(PH) Alas!
ལའི-ཁར	(PH) at the summit of a mountain pass
ལག	(PH) Hasta [Indian constellation]
ལག-རྗེ-ལུག-རྗེ	(PH) exchanging merchandise
ལགས-ན-རིན-པོ-ཆེ	(PH) Ratnapāṇi
ལམ	(PH) radiant; vivid
ལམ-བགྲོད-ཚུལ	(PH) mode of progressing on the path
ལམ-བཟང	(PH) excellent path
ལམ-ག	(PH) roadside; side of the road
ལམ-གྱི-བཞི-མདོ	(PH) four-way crossroads
ལམ-མེད	(PH) trackless
ལམ-མཐོང-སྤང-ཉོན-མོངས-བཅུ	(PH) ten afflictions to be abandoned by the path of seeing [related to the Noble Truth of] the Path
ལམ-ཉེ-བ	(PH) short path
ལན	(PH) time; times
ལན-བཏབ-པ	(PH) answers given
ལན-བཏབ-པོ	(PH) answers given
ལན-གཅིག	(PH) once
ལན-གཅིག-ཕྱིར	(PH) Once-returner
ལན-གཅིག-ཕྱིར-མི-ལྡོག-པ	(PH) Once-returner
ལན-གསུམ	(PH) three times
ལན-མང-དུ	(PH) in many ways
ལན-རེ	(PH) one time; once
ལན-རེ-རེ	(PH) one time; once
ལན-རེ-རེ-གཉིས-གཉིས	(PH) once or twice
ལན-རེ-རེ-གཉིས-གཉིས-ཙམ	(PH) merely once or twice
ལང-ཚོ	(PH) youth; full bloom
ལས-བུམ-སྒྲུབ-པ	(PH) consecration of the action vase
ལས-ཀྱི-རླུང	(PH) wind of karmic action
ལས-ཉོན-གྱི-དབང	(PH) the force of [contaminated] actions and afflictions
ལས-རབ-འབྱམས	(PH) infinite activities
ལས-རླུང	(PH) wind of karmic action
ལས-ཐབས	(PH) method of preparation
ལྕགས-ཁབ	(PH) [iron] needle
ལྕེའི-སྒོར-རྒྱུ-བའི-རླུང	(PH) wind that moves through the door of the tongue
ལྡོག-པ	 (PH) isolate; difference; opposite|(PH) isolate; difference; opposite 
ལྡོག-པ-གཟུང-རྟོག	(PH) conception of [the true existence of] objects which is to be turned away from [by Bodhisattvas]
ལྡོག-པ-གཟུང-རྟོག-དགུ	(PH) the nine conceptions of [the true existence of] objects to be turned away from [by Bodhisattvas]
ལྡོག-པ-ངོས-འཛིན	(PH) identifying isolates
ལྡོམ-བུ-པ	(PH) mendicant
ལྡོང-རོས	(PH) mineral medicine; realgar
ལེ-ལོ-དག	(PH) two [kinds of] laziness
ལེགས-སྤྱད	(PH) good deed
ལྷ	(PH) deity; god; divinity; goddess; heavens; cloud
ལྷ-བྲིས	(PH) artist
ལྷ-ཆེན-པོ	(PH) Mahādeva
ལྷ-ཅིག	(PH) princess
ལྷ-དབང	(PH) lord of the gods; deity empowerment
ལྷ-མ-སྲིན-སྡེ-བརྒྱད	(PH) eight classes of gods and raksas
ལྷ-མོ-ཆེ	(PH) great goddess
ལྷ-རེག	(PH) ornate silk khata
ལྷ-རིག-པའི-སེངགེ	(PH) *Devavitsiṃha
ལྷ-སྡེ	(PH) groups of gods
ལྷ-སྒྲུང	(PH) folk opera
ལྷ-ཤེས	(PH) diviner
ལྷ-ཤེས-མ	(PH) diviner
ལྷ-སྲིན	(PH) gods and demons (rakṣasa)
ལྷ-ཡེ-ཤེས-སེམས-དཔའ	(PH) divine wisdom being (jñānasattva)
ལྷའི-བུ-འགྲོ-མགྱོགས	(PH) Devaputra Aśvins
ལྷག-བསམ-དག-པ	(PH) pure unusual attitude
ལྷག-པ	(PH) more
ལྷག-པའི-བསམ-པ-བརྟན-པ	(PH) Sthīrādhyāśaya
ལྷག-པའི-ལྷ	(PH) special deity; own particular deity
ལྷག-པར-བྱ-བ	(PH) outstanding deed
ལྷག-པར-རྣལ-འབྱོར	(PH) Atiyoga
ལྷག-པོར	(PH) surpassingly
ལྷག-ཙམ	(PH) little more (than)
ལྷམ	(PH) shoe
ལྷན-ཅིག-བྱེད-པའི-རྒྱུ	(PH) cooperating cause
ལྷན-ཅིག-བྱེད-པའི-རྐྱེན	 (PH) cooperating condition|(PH) cooperating condition 
ལྷན-ཅིག-བྱེད-རྐྱེན	 (PH) cooperating condition|(PH) cooperating condition 
ལྷན-ཅིག-ཏུ	(PH) together; together with
ལྷན-ཅིག-ཏུ-སྐྱེས-པ	(PH) coemergent
ལྷན-རྒྱས	(PH) together
ལྷན-སྐྱེས-བདེ-སྟོང	(PH) innate bliss-and-emptiness
ལྷང	(PH) clear
ལྷོའི-འདོད-མ	(PH) ″desirous″ southern [right] channel at the heart
ལྷོད-ལྷོད-པོ	(PH) loose; very loose
ལྷོད-པ-ཉིད	(PH) loose
ལྷུན-གྲུབ-བརྩེགས	(PH) "Spontaneously Accomplished Mound" [n. of a charnel ground]
ལྷུན-གྲུབ-ཆོས-སྐུ	(PH) spontaneously established Truth Body
ལྷུན-གྲུབ-གཟུགས-སྐུ	(PH) spontaneously established Form Body
ལྷུན-གྱིས-གྲུབ-པ	(PH) spontaneous
ལྷུན-པོ	(PH) beautiful
ལྷུང-བཟེད	(PH) alms bowl
ལི	(PH) verbal root
ལཱི	(PH) verbal root
ལི-བྱིན	(PH) *Ghaṇṭadatta
ལྗང-བ	(PH) dark-colored
ལྗོན-ཤིང	(PH) tree
ལྔ-པོ-འཕྲོད	(PH) five-fold alignment
ལོ-བསྐོར	(PH) [sixty-year] cycle of years
ལོ-མ-བདུན-རི	(PH) seven-petaled mountain
ལོ-པཎ	(PH) translators and paṇḍitas
ལོ-སྐོར	(PH) [sixty-year] cycle of years
ལོ-ཙཱ-བ-ཀ-ཅོག-ཞང	(PH) translators Ka-wa [Pel-tsek (ka ba dpal brtsegs)]; Jok-ro [Lü-gyal-tsen (cog ro klu'i rgyal mtshan)]; and Zhang [Na-nam Ye-she-de (zhang sna nam ye shes sde)]
ལོ-ཚིགས	(PH) chronology
ལོ-ཙཚ-བ	(PH) translator
ལོ-ཙཚ-བ-ཀ-ཅོག-ཞང	(PH) translators Ka-wa [Pel-tsek (ka ba dpal brtsegs)]; Jok-ro [Lü-gyal-tsen (cog ro klu'i rgyal mtshan)]; and Zhang [Na-nam Ye-she-de (zhang sna nam ye shes sde)]
ལོག-པ	(PH) reverse; opposite; unreal; mistaken
ལོག-པའི-ཀུན-རྫོབ	(PH) unreal conventional [truth]
ལོག-པའི-ཀུན-རྫོབ-བདེན-པ	(PH) unreal conventional truth
ལོག-ས-ཐ-དད	(PH) different bases of reversal
ལོག-ས-ཐ-དད-ལས-ལྡོག-པ	(PH) reversed from different bases of reversal
ལོགས-སུ	(PH) to the edge (of); separately; apart; as different (than); as other (than)
ལོང-བ-རྐང-ཅན	(PH) a blind person with good legs
ལོང-བྱ	(PH) objects of enjoyment
ལོང-ག	(PH) large intestine
ལོང-མེད	(PH) no time [to waste]
ལོང-སྤྱོད	(PH) enjoyment; resources; wealth
ལྟ-བ-མཐར-ཐུག	(PH) final view
ལྟ-བ-སྐྱོང	(PH) internalize the view [of emptiness]
ལྟ-བའི-གོལ-ས	(PH) faulty view
ལྟ-ཅི-སྨོས	(PH) what need is there
ལྟ-ལ-ཅི-སྨོས	(PH) what need is there
ལྟ-སྨོས-ཀྱང-ཅི	(PH) what need is there
ལྟ-ཞིག	(PH) just such a one
ལྟར-པོ	(PH) "lump" [n. of a stage of development of the embryo in the third week]
ལྟེ-བ	(PH) hub; center
ལྟོ-འཕྱེ-ཆེ	(PH) Mahoraga
ལྟོ-བགྲངས	(PH) full stomach
ལྟོ-སྐལ	(PH) tax-base
ལུགས-འབྱུང-དུ	(PH) in the forward process
ལུམ-བི-ནཱི	(PH) Lumbinī
ལུང-བསྟན	(PH) prophecy; scriptural teaching
ལུང-དང-སྦྱར-བ	(PH) connection to scripture
ལུང-གི-མངལ-འཇུག	(PH) Scripture on Entering the Womb
ལུས	(PH) body
ལུས-དྲན-པ-ཉེར-གཞག	(PH) application of mindfulness based on the body
ལུས-གཅེར-བུ	(PH) going naked
ལུས-གཅོམ	(PH) physical strength
ལུས-ཀྱི-བྱ-བ	(PH) activities of the body; physical actions
ལུས-ཤིན-སྦྱངས	(PH) physical pliancy
ལུས-ཡུལ-དུས	(PH) body; environment; and time
ལྭ-བ-པ	(PH) Kambalapāda
མ-འཇིགས-པའི-སྤོབས-པ་	(PH) fearless confidence
མ-འོངས	(PH) future; future [phenomena]; [phenomena that exist in the] future
མ-འོངས-པའི-དོན	(PH) future goal
མ-བརྟགས-མ-དཔྱོད-པའི-བློ-ལྷན-སྐྱེས	(PH) an innate awareness that neither investigates nor analyses
མ-དག-གཞན-དབང	(PH) impure other-powered natures
མ-དག-པ-གཞན-གྱི-དབང	(PH) impure other-powered natures
མ-དག-སྐྱེ-ཤི-བར-དོ	(PH) impure birth; death; and the intermediate state
མ-དྲོས	(PH) Anavatapta
མ-དྲོས-མཚོ	(PH) Anavatapta [the Ever Cool Lake, another name for lake Manasarovar]
མ-དུལ-འབ	(PH) the untamed
མ-ཁད	(PH) as soon as; just done; just recently
མ-ཁད-དུ	(PH) as soon as; just done; just recently
མ-མོ	(PH) [n. of mystical formulae or diagrams which use permutations of the alphabet]
མ-ངེས-པའི-རིགས	(PH) indefinite lineage [of person]
མ-ངེས-རྟགས	(PH) uncertain sign; indefinite sign
མ-ནོར-ལམ	(PH) the unmistaken path
མ-ནུས-ཉམ-ཐག	(PH) destitute and powerless
མ-ཕྱི	(PH) draft; preliminary version
མ-རིག-པའི-མུན-པ	(PH) darkness of ignorance
མ-རུངས-པ	(PH) wild beast
མལ-སྟན	(PH) bed
མན	(PH) on and below; henceforward
མན-ཆད	(PH) on and below; henceforward
མན-ཆད-དུ	(PH) on and below
མང-འགྱེད	(PH) common [tea] and [monetary] distributions
མང-བཀུར-སྡེ	(PH) Saṃmitīyā schools
མང-བསྐུར-སྡེ	(PH) Saṃmitīyā schools
མང-གྲངས	(PH) many
མང-ཉིད	(PH) magnitude; plurality
མང-པོས-བཀུར-བ	(PH) Saṃmitīyā school
མཉཛུ-གྷོ-ཤ-ཡ	(PH) Mañjughoṣa
མར	(PH) lower; downward
མར-གྱི-མཚམས-མེད	(PH) direct transition downward
མས-རླུང	(PH) lower wind
མཆེ-བ	(PH) fangs; tusks
མཆེད	(PH) brother
མཆིམས-ནམ-མཁའ-གྲགས	(PH) Chim Nam-ka-drak
མཆོད-བརྗོད	(PH) salutation verse; verse of offering
མཆོད-གནས	 (PH) object of worship|(PH) (hon.) religious figure; monk; priest 
མཆོད-པའི-རྫས	(PH) ritual offering substances
མཆོད-རྫས	(PH) ritual offering substances
མཆོད-སྦྱིན-གྱི-རིག-བྱེད	(PH) Yajurveda
མཆོད-ཡོན	(PH) priest-patron [relationship]
མཆོག-འདོད-སེམས-ཅན	(PH) sentient beings desirous of ultimate [bliss]
མཆོག-གི-དངོས-གྲུབ-རྣམ-པ-གསུམ	(PH) three kinds of supreme siddhis [of body; speech; and mind]
མཆོག-གི-རབ-ཏུ-ས	(PH) supreme land
མཆོག-གསུམ	(PH) Three Jewels
མདངས	(PH) tone; complexion; radiance
མདངས-གསལ	(PH) clear complexion
མདོ	(PH) concise statement; short sentence; axiom
མདོ-ཁམས	(PH) Eastern Tibet; (hon.) Kham
མདོ-རྫི	(PH) river breeze; a wind blowing at open places where rivers meet
མདོ-སྡེ-སྤྱོད-པའི-དབུ-མ	(PH) Sautrantika-[Svātantrika]-Mādhyamika; Middle Way [Autonomy School] Following Sūtra
མདོ-སྡེ-སྤྱོད-པའི-དབུ-མ-པ	(PH) Sautrantika-[Svātantrika]-Mādhyamika; Middle Way [Autonomy School] Following Sūtra
མདོ-སྡེ-སྤྱོད-པའི-དབུ-མ-རང-རྒྱུད-པ	(PH) Sautrāntika-Svātantrika-Mādhyamika; Middle Way Autonomy Following Sūtra [School]
མདོ-ཙམ-དུ	(PH) briefly
མདོ-ཟ-མ-ཏོག-བཀོད-པ	(PH) "Chest of Jewels Sutra" (Karaṇḍavyūha Sūtra)
མདོངས	(PH) "eye" [in a peacock's feathers]
མདོངས-པ	(PH) forehead
མདོར-བསྡུས	(PH) short form; condensation; condensed; brief
མདུད	(PH) knot
མདུད-པ-དྲུག-སྐོར	(PH) six-circled knot
མདུན-མ	(PH) concern
མདུན-ས	(PH) (in) the presence (of); before
མདུན-ས-དག	(PH) the presence of those
མཛའ-བོ	(PH) friend
མཛའ-མོ	(PH) lover
མཛངས-བླུན-མདོ	(PH) Sūtra of the Wise and the Foolish
མཛངས-པ	(PH) wise; learned
མཛེ-པོ	 (PH) leper|(PH) leper 
མཛོད	(PH) [Vasubandhu's] ″Treasury [of Manifest Knowledge]″ (abhidharmakośa); beautiful; handsome; fine
མཛུབ-གུ	(PH) finger
མཛུབ-ཁྲིད	(PH) instructions
མེ-འབར-བའི-རླབས	(PH) whirlwind of blazing fire
མེ-འབར-བའི-རླུབས	(PH) pit of blazing fire
མེ-བཙའ	(PH) moxibustion; acupuncture
མེ-དྲོད	(PH) warmth
མེ-ལྔ-བརྟེན-པ	(PH) relying on the five fires [fires in front; back; on both sides; and the sun above]
མེ-ལོང-ངོས-གཉིས-པ	(PH) a two-sided mirror
མེ-ལྟ-བུ	(PH) like fire
མེད-བཞིན-དུ	(PH) not actually
མེད-མི-རུང	(PH) indispensible
མེས	(PH) ancestor; patriarch
མེས-དབོན	 (PH) ancestral; ancient [kings]|(PH) ancestor and grandchild 
མགོ	(PH) head; start; beginning; top; Mṛgaśiras [Indian constellation]
མགོ-མཇུག-པ	(PH) beginning and end; two ends
མགྲིན-པ	(PH) neck
མགྲོན-ཆེན	(PH) chamberlain (2nd rank)
མགྲོན-གཉེར-ལས-བྱེད	(PH) assistant to the chamberlain (4th rank)
མགུལ-སྲུང	(PH) protection amulet
མི-འཁྲུགས-པ	(PH) Akṣobhya
མི-བདེན	(PH) untrue
མི-བརྟན-ཉིད	(PH) unstable
མི-བསླུ	(PH) incontrovertible; ineluctible; undeceived; inevitable; unfailing
མི-དལ-ཀུན	(PH) all states of non-leisure
མི-དགེ-བའི-སེམས-བྱུང	(PH) non-virtuous mental factors
མི-དགེ-ཉེས-ཆེན	(PH) great demerit
མི-དྲེད	(PH) yeti
མི-གང	(PH) one person
མི-ལྡོག-པ-ཡི-སེམས	(PH) irreversible mind; irreversible intention
མི-ལྡོག-པའི-སེམས	(PH) irreversible mind; irreversible intention
མི-མཇེད	(PH) obdurate
མི-ཕྱེད-པ	(PH) [the Sthavira] Abhedya
མི-རིག-འཁྲུལ-སྣང	(PH) deluded ignorance
མི-རྗེ	(PH) governor
མི-སྡེ	(PH) groups of humans
མི-ཤིགས	(PH) indestructible; uninterruptedly
མི-ཤིགས-པ	(PH) indestructible; uninterrupted
མི-ཤིགས-པའི-ཐིག-ལེ	(PH) indestructible drop
མི-སྐྱེ-བར-ཤེས-པ	(PH) cognition of non-production
མི-སྐྱོད-རྡོ-རྗེ	(PH) Mi-kyö-dor-je [Eighth Karma-pa]
མི-སྣང-བའི-འབྲེལ-ཟླ-མ-དམིགས-པའི-རྟགས-ཡང-དག	(PH) sign which is a non-observation of a related object
མི-སྣང-བའི-འགལ-ཟླ-མ-དམིགས-པའི-རྟགས-ཡང-དག	(PH) a correct sign of the nonappearing which is an observation of a contradictory object
མི-ཞིམ	(PH) unfragrant
མིའི-རྟེན	(PH) a human body
མིའི-རུས-པའི-ཕུར-བུ	(PH) human bone dagger
མིག	(PH) eye; pupil of the eye
མིག-གི-སྒོར-རྒྱུ-བའི-རླུང	(PH) wind that moves through the door of the eyes
མིག-མཐོང	(PH) foreteller; a looker into the future
མིག-ནད	(PH) diseases of the eye
མིག-སླེ	(PH) cross-eyed
མིང	(PH) word (free morpheme)
མིང-ཆེ-ཆེ	(PH) famous; great fame
མིང-དང-རྟོག-པས-བཏགས-ཙམ	(PH) merely posited by names and concepts
མིང-གང-ལགས	(PH) any such designated
མིང-གི-ཚོགས-བཏགས	(PH) nam
མིང-རྐྱང	(PH) nominally
མཇུག-གི-དོན	(PH) conclusion
མཁའ-འདྲའི-སྣང-བ	(PH) fireflies
མཁའ-དབྱིངས	(PH) expanse of space
མཁའ-དབྱིངས-ཕྱག-རྒྱ	(PH) space mudra
མཁའ-མཉམ-ལུས-ཅན	(PH) [all] beings as infinite as space
མཁའ-སྤྲིན-ཅན	(PH) "clouded sky"; [n. 7th month]
མཁའ-སྤྱོད-དབང-པོ	(PH) lord of khecaris
མཁའ-སྤྱོད-པའི-རིག-འཛིན	(PH) sky-traveling tantric adept
མཁའ-སྤྱོད-རིག-པ-འཛིན-པ	(PH) sky-traveling tantric adept
མཁའ-སྤྱོད-ཞིང	(PH) realm of sky-travellers; celestial realm
མཁའ-སྟེང-འགྲོ	(PH) [planet] Mars
མཁན-བརྒྱུད-རྙིང-ཕ	(PH) old preceptor lineage
མཁན-པ	(PH) guide
མཁར	(PH) walking stick
མཁས-གྲུབ	(PH) Ke-drup Ge-lek-bel-sang-bo (mkhas grub dge legs dpal bzang po; 1385-1438)
མཁོ-བའི-ཡོ-བྱད-ཕྲན-ཚེགས	(PH) minor articles of necessity
མཁྲིས	(PH) bile
མཁྲིས-པའི-སྤྱི-རྟགས-བདུན	(PH) seven general signs of bile
མཁྱེན-བརྩེ	(PH) wisdom and compassion; wise and compassionate
མཁྱེན-རབ	(PH) Khyenrap
མནན	(PH) pressure
མནར-མེད	(PH) Avīci [Hell]
མནར-མེད-དམྱལ-བ	(PH) Avīci Hell
མནར-མེད-ཀྱི-དམྱལ-བ	(PH) Avīci Hell
མནར-མེད-པ	(PH) Avīci [Hell]
མངའ-བདག-ཁྲི-རལ-པ-ཅན	(PH) King Ralpajen
མངའ-བདག-ཉང-རལ-པ-ཅན	(PH) King Ralpajen of Nyang
མངའ-རིས	(PH) subordinates/ subjects
མངའ-ཐང	(PH) power; control
མངའ-ཐང-འབྱོར-བ	(PH) power and fortune
མངག-གཞུག	(PH) servant
མངོན-བརྗོད	(PH) synonyms
མངོན-དགའ-ཞིང	(PH) Abhirati ["great joy", the Buddhafield of Akṣobhya]
མངོན-ལྐོག	(PH) manifest [phenomena] and hidden [phenomena]
མངོན-ལྐོག-གཉིས	(PH) the two -- manifest [phenomena] and hidden [phenomena]
མངོན-མཐོ-ངེས-ལེགས	(PH) high status [within cyclic existence] and definite goodness [of liberation from cyclic existence and/or omniscience]
མངོན-མཐོའི-གོ-འཕང	(PH) a state of high status
མངོན-པའི-གཞུང	(PH) Manifest Knowledge (abhidharma) texts
མངོན-པར-དགའ-བ	(PH) Abhirati [the Buddhafield of Akṣobhya]
མངོན-ཤེས-སྐྱེད-པ-ཉིད	(PH) the very generation of the clairvoyances
མངོན-སུམ-དང-པོ-བ	(PH) initial perceptions
མངོན-སུམ-དུ	(PH) manifestly; evidently; directly
མངོན-སུམ-ཚད-མ	(PH) valid perception
མངོན-སུམ-ཚད-མ-བཞི	(PH) four types of valid perception
མཉམ-བཞག-ཕུང-གསུམ-པ	(PH) a third category of meditative equipoise
མཉམ-བཞག-ཐུན-གཅིག	(PH) one session of meditative equipoise
མཉམ-མེད-ཟས-གཙང-སྲས-པོ	(PH) the unequalled son of Śuddhodana
མཉམ-པར-འཇོག-པ	(PH) setting in equipoise [the 9th mental abiding (sems gnas)]
མཉམ-རྗེས-གཉིས	(PH) the two — meditative equipoise and subsequent attainment
མོད	(PH) moment; the very moment; the same time
མོང-རྟུལ-བ-ཉིད	(PH) utterly deluded
མཐའ-འཁོབ	(PH) border country; barbarian land
མཐའ-དག	(PH) all; entire
མཐའ-དྲུག-ཚིག	(PH) six delimiter explanations
མཐར-འཛིན-ལྟ-བ	(PH) view holding to an extreme
མཐར-ཆགས	(PH) series; order
མཐར-ཕྱིན-པའི-ལམ	(PH) path of completion
མཐར-ཐུག-གི-མཁྱེན-པ	(PH) a final exalted knower
མཐིང-རིལ-ངུར-པ	(PH) blue-winged duck
མཐོ	(PH) span
མཐོ-དམའ	(PH) higher [and] lower
མཐོན-པོ	(PH) high [level of]; high; elevated; rarified
མཐོང-བས-གྲོལ-བ	(PH) liberation through being seen
མཐོང-གྲོལ	(PH) liberation through being seen
མཐོང-གྲོལ-སྐུ	(PH) body [which] liberates [merely through] being seen
མཐོང-ལམ-བར-ཆད-མེད-ལམ	(PH) uninterrupted path of a path of seeing
མཐོང-ལམ-བཟོད-པ-བརྒྱད	(PH) the eight forbearances of a path of seeing
མཐོང-ལམ-མཉམ-བཞག-ཡེ-ཤེས	(PH) exalted wisdom of meditative equipoise of the path of seeing
མཐོང-ལམ-རྗེས-ཐོབ-ཡེ-ཤེས	(PH) exalted wisdom of subsequent attainment of a path of seeing 
མཐོང-ལམ-རྣམ-གྲོལ-ལམ	(PH) path of release of a path of seeing
མཐོང-ལམ-རྣམ-པར-མི-རྟོག-པའི-ཡེ-ཤེས	(PH) non-conceptual exalted wisdom of the path of seeing
མཐོང-ལམ-ཤེས-བཟོད-སྐད-ཅིག-མ-བཅུ-དྲུག-པོ	(PH) the sixteen moments of forbearance and knowledge of the path of seeing
མཐོང-སྤང-ཉོན-མོངས	(PH) afflictions that are to be abandoned by the path of seeing
མཐོང-སྤང-ཉོན-མོངས-བཅུ	(PH) ten afflictions that are to be abandoned by the path of seeing
མཐོང-སྤང-ཉོན-མོངས-བརྒྱ-དང-བཅུ-གཉིས	(PH) one hundred and twelve afflictions that are to be abandoned by the path of seeing
མཐོང-སྤང-ཤེས-སྒྲིབ	(PH) obstructions to omniscience that are to be abandoned by the path of seeing
མཐོང-སྤང-ཤེས-སྒྲིབ-བརྒྱ-དང-བརྒྱད	(PH) one hundred and eight obstructions to omniscience that are to be abandoned by the path of seeing
མཐུ-སྐྱེས	(PH) strength
མཚམས-ཀྱི-རྩ-འདབ-བཞི	(PH) four channel-petals of the intermediate directions
མཚན	(PH) name; sign
མཚན-བཅས-རྩོལ-བཅས	(PH) having signs and having effort
མཚན-བཅོས	(PH) having signs
མཚན-དང-ལྡན-པ	(PH) fully-qualified; named
མཚན-དོན	(PH) etymology; meaning of the name
མཚན-ལྡན	(PH) fully-qualified; named; genuine
མཚན-མཆོག	(PH) supreme name
མཚན-མོ-ཟླ-བ	(PH) nighttime moon; the moon at night
མཚན-ཉིད	(PH) logical reasoning [literary genre]; distinctive symptom
མཚན-ཉིད-དང-ལྡན-པའི-བླ-མ	(PH) fully-qualified teacher
མཚན-ཉིད-ལྡན	(PH) fully-qualified
མཚན-སྔགས	(PH) name-mantra
མཚན-ཞབས་	(PH) debate partner
མཚང-འབྲུ-བའི-བསམ-པ	(PH) the intention to describe the faults [of others]
མཚོན	(PH) weapons; instance; example; illustration
མཚོན-བྱ-དོན	(PH) indicated meaning
མཚོན-བྱེད	(PH) valid illustrator
མཚོན-ཆ	(PH) sword; weapon
མཚོན-དོན	(PH) exemplifying meaning
མཚོན-གྱི-བསྐལ-པ	(PH) the age of weaponry
མཚོན-ན	(PH) for instance
མཚོན-པ	(PH) illustration
མཚོན-པའི-བརྡ	(PH) illustrative sign
མཚོན-རྣོན	(PH) sharp sword
མཚོན-རྟགས	(PH) indicating sign
མཚོན-ཙམ	(PH) merely indicative
མཚུངས-མ-མེད	(PH) unequalled; incomparable
མཚུངས-མེད	(PH) unequalled; incomparable
མཚུངས-མེད-བླ-མ	(PH) incomparable guru
མཚུངས-མེད-སེམས	(PH) incomparable [state of] mind
མཚུངས-པ-མེད-པ	(PH) unequalled; incomparable
མཚུངས-ཟླ	(PH) rival; approximate
མཚུངས-ཟླ-མ-མཆིས-པ	(PH) peerless; without rival
མུ-སྟེག-བྱིས-པ	(PH) the child-like Forders
མུ-སྟེགས-ཅན-གྱི-རྣལ-འབྱོར	(PH) yogic practice of a non-Buddhist
མུ-ཐུག	(PH) limit
མུན-པ-ཅན-གྱི-ང-རྒྱལ	(PH) darkness-dominated I-principle
མུན-ཚོགས	(PH) gloom; mass of darkness
མྱ-ངན-ལམ-གོལ	(PH) deviant path of suffering
མྱ-ངན-ལམ-གོལ-འཁྱམས-པ	(PH) wanderer on the deviant path of suffering
མྱང-འདས-གཉིས	(PH) two [kinds of] nirvāṇa
མྱེས	(PH) ancestor(s)
མྱུར-བའི-ལས	(PH) epicycle correction
མྱུར-བར	(PH) quickly
མྱུར-བྱོན-གསོལ-འདེབས	(PH) supplication for swift return
མྱུར-མཛད-མ	(PH) Kurukullā
ནཡ-གྲོ-དྷ་	(PH) Nyagrodha [name of a vihāra in Kapilavastu; also of one in Rajagṛha]
ན	(PH) if; when [syntactic particle]; suitable age; stage of life; meadow; pasture land
ན-བ	(PH) sickness
ན-བཟའ	(PH) clothing; dress; clothes
ན-བཟའ-བརླག-པ	(PH) [King] Śālivāhana
ན-བཟའ-དམ-པ	(PH) best clothing
ན-བཟའ-དཀར-མོ	(PH) Pāṇḍaravāsinī
ན-ལ-ད	(PH) Nalanda
ན-ལན-ད	(PH) Nalanda
ན-མོ-དབང-པོ	(PH) sense faculties
ན-ཚིག	(PH) condition
ནད-གདོན	(PH) disease and harmful influences
ནད-གདོན-བར-ཆད	(PH) disease; harmful influences; and obstacles
ནད-གདོན-ཅན	(PH) one [afflicted] with disease or harmful influences
ནད-གདོན-སྡིག-སྒྲིབ	(PH) disease; harmful influences; ethical transgressions; and obstructions
ནད-མེད-མ	(PH) non-menstruating woman
ནད-ཡམས	(PH) plague; epidemic
ནག-ཕྱོགས	(PH) dark side; waning part [of the moon]
ནམ	(PH) [interrogative particle]; when; time; as soon as; as is appropriate; accordingly
ནམ-འཆི	(PH) time of death
ནམ-དུ-ཡང	(PH) ever; always; absolutely
ནམ-མཁའི-དབྱིངས	(PH) expanse of space
ནམ-མཁའི-དབྱིངས-ཀྱི-དབང-ཕྱུག-མ	(PH) Akāśadhatviśvarī
ནམ-ཡང	(PH) ever; always; absolutely
ནམ-ཞིག	(PH) at the time
ནམས-ཀྱང	(PH) at any time
ནན-ཏན-ཆེན-པོ	(PH) earnestness; great sincerity
ནང	(PH) within; among
ནང-བདག-བསམ-པ	(PH) inner contemplation
ནང-གི-བྲག-ཆ	(PH) echo
ནང-གི-དུར-ཁྲོད-བརྒྱད	(PH) inner eight charnel grounds
ནང-ཁུལ	(PH) inside
ནང-རེ-དགོངས-རེ	(PH) every morning and every evening
ནང-ཐུགས-སྲས	(PH) inner heart-son
ནར-མ	(PH) plain; ordinary
ནར-མར	(PH) always; continuously
ནར-མོ	(PH) elongated; oblong
ནས	(PH) [gerund marker]; barley
ནེལ-པ	(PH) Nel-pa [Paṇḍita Drak-pa-mön-lam-lo-drö (nel pa paṇḍi ta grags pa smon lam blo gros)]
ང-རྒྱལ	(PH) self-confidence; I-principle; ego
ང-རྒྱལ-གཅོམ	(PH) pride and conceit
ང-རོ	(PH) roar; pronunciation
ང-རོ-ཆེན-པོ	(PH) great roar
ང-རོའི-རྣམ-པ	(PH) tone
ང-ཙམ	(PH) mere "I"; mere notion of a self
ངག-མི-སྨྲ-བ	(PH) not speaking
ངན-སེམས	(PH) evil thought; evil intent
ངན-སོང-སེལ	(PH) *Durgati-pariśodhana/*Durgatyapoha/*Apāyāpoha [p.n. of Bodhisattva]
ངར	(PH) rough; coarse
ངེས-བྱས-བཅས-པ-དང-རང-བཞིན	(PH) transgressions [of vows] and natural [offenses]
ངེས-པ-ཉིད	(PH) ascertainment (a consciousness)
ངེས-སྡོམ	(PH) self-restraint; resolute restraint
ངོ	(PH) [terminating particle]; with respect to; relative to; from the perspective of
ངོ-བོ	(PH) entity; actuality; object
ངོ-བོ-སོ-སོ-བ	(PH) discrete entities
ངོ-བོའི-ཁྱད-པར-མི-འདྲ-བ	(PH) essential difference
ངོ-ལ	(PH) with respect to; relative to; from the perspective of
ངོ-མཚར	(PH) amazing; splendor
ངོ-མཚར-དོན	(PH) marvelous meanings
ངོ-རོ-བར	(PH) in one's face
ངོ-ཚ-ཁྲེལ	(PH) modesty and shame
ངོགས	(PH) port; entrance; ford; bank; shore; face; side
ངོམས	(PH) satisfaction
ངོས	(PH) side; surface; myself
ངོས-ནས	(PH) from the side (of); from the point-of-view (of); by way (of)
ངོས-ནས-གྲུབ-པ	(PH) establishment from the side [of the basis of designation]
ངོས-ནས-གྱི	(PH) because of
ངོས-སྐལ-གྱི-སྤང-བྱ	(PH) respective objects of abandonment 
ངུར-པ	(PH) duck
ངུར-སྨིག-འཛིན-པ	(PH) saffron-clothed; monk
ངུར-སྨྲིག	(PH) saffron
ངུར-སྨྲིག-འཛིན-པ	(PH) one who wears saffron (i.e. monk [Buddhist])
ངུར-སྨྲིག-གོས	(PH) saffron-robes
ནོངས-པ	(PH) fault; error
ནོར-བདག	 (PH) lord of wealth | (PH) remover of obstacles|(PH) lord of the treasury 
ནོར-བཟང	(PH) Sudhana
ནོར-མཆོག	(PH) precious jewel
ནོར-ཕྱུག-པ	(PH) wealthiest man
ནོར-རྒྱས	(PH) [the Nāga King] Vāsuki
ནུབ-ཀྱི-ཁྱིམ-མ	(PH) ″householder″ west [back] channel at the heart
ནུར-ནུར-པོ	(PH) "elogated" [n. of a stage of development of the embryo]
ནུས-ཁྱད-པར-ཅན	(PH) special capacity
ནུས-པ	(PH) indication
ནུས-པ-ཁྱད-པར-ཅན	(PH) special capacity
ནུས-པ-ཐོགས-མེད	(PH) an unimpeded capacity
ནུས-པའི-སྒོ-ནས	(PH) by way of their capacity
ཉ-དབོན-ཀུན-དགའ-དཔལ	(PH) Nya-won Kun-ga-pel (1300-1380 ce.) 
ཉག-གཅིག	(PH) sole unique
ཉམ-ཆུང-ཉིད	(PH) weak
ཉམ-ཅུང-བ	(PH) weak
ཉམ-ང-བར	(PH) fearfully
ཉམ-ཐག-འགྲོ	(PH) destitute transmigrators
ཉམ-ཐག-པ	(PH) destitution; destitute
ཉམ-ཐག-སྐལ-དམན	(PH) unfortunate and destitute
ཉམས	(PH) state; experience; thought; apprehension
ཉམས-དགའ-བ	(PH) very pleasant
ཉམས-གཅིག	(PH) single moment [of experience]
ཉམས-ལེན	(PH) practice
ཉམས-ལེན-གྱི-ཆ	(PH) elements of practice
ཉམས-ལེན-གྱི-མཆོག	(PH) supreme practice
ཉམས-པ	(PH) pain; thoughts
ཉམས-སྟོབས	(PH) strength
ཉམས-སུ-ལེན-པའི-ཚུལ	(PH) way to practice
ཉམས-ཐག	(PH) stricken; destitute
ཉམས-ཞིབ	(PH) details
ཉན-པོ-སྣོད	(PH) fit vessel
ཉན-རང	(PH) Śrāvakas and Pratyekabuddhas
ཉན-རང-འཕགས-པ	(PH) Śrāvakas; Pratyekabuddhas; and Āryas; Ārya Śrāvakas and Pratyekabuddhas
ཉན-རང-གི-ལམ	(PH) Śrāvaka and Pratyekabuddha paths
ཉན-རང-གི-ཐེག-པ	(PH) Śrāvaka and Pratyekabuddha Vehicles
ཉན-རང-གཉིས	(PH) both Śrāvakas and Pratyekabuddhas
ཉན-ཐོས-ཀྱི-མི-སློབ-ལམ	(PH) Hearer's path of no more learning
ཉན-ཐོས-ཀྱི-སྦྱོར-ལམ-དྲོད	(PH) Hearer heat path of preparation
ཉན-ཐོས-མཐོང-ལམ-པ	(PH) a Hearer on the path of seeing
ཉེ-འཁོར	 (PH) neighboring [hell]|(PH) near; nearby; range (of) 
ཉེ-བའི-ཕྱོགས	(PH) adjacent
ཉེ-བར-ཉོན-མོངས-པ	(PH) secondary afflictions (upakleśa)
ཉེ-གནས-ཉིད	(PH) disciple
ཉེ-ལམ	(PH) short path; short cut
ཉེ-རབས	(PH) recent generation
ཉེར-འཚེ-བའི-དམྱལ-བ	(PH) trifling hells
ཉེར-གཅིག	(PH) twenty-one
ཉེར-སྡོགས	(PH) preparation
ཉེར-ཐོབ-ནག-ལམ-པའི-སེམས	(PH) mind of radiant black near-attainment
ཉི-འོག-པ	(PH) Aparāntaka [subshool of the Vaibhāṣika]
ཉི-གདུགས	(PH) parasol
ཉི-ཧོང	(PH) Japan; Japanese
ཉི-མ-ཕྱེད-དུས	(PH) noonday sun
ཉི-ཤུ-རྩ-གཅིག	(PH) twenty-one
ཉི-ཚེའི-བདག	(PH) individual 'Self'
ཉིན-མོ-དགུང-ཐུན	(PH) afternoon session
ཉིན-ཤས	(PH) a few days
ཉིང-མཚམས-སྦྱོར-བ	(PH) [instance of] taking rebirth
ཉོན-མོངས-ཅན-གྱི-གཉིད	(PH) afflicted sleep
ཉོན-མོངས-གཟུང	(PH) afflicted objects
ཉོན-མོངས-གཟུང-རྟོག-མངོན-འགྱུར	(PH) the manifest conception of afflicted objects
ཉོན-མོངས-ཤེས-བྱ-ཡི-སྒྲིབ-པ	(PH) afflictive obstructions and obstructions to omniscience
ཉོན-སྒྲིབ-ཀུན-བཏགས-བརྒྱ-དང-བཅུ-གཉིས	(PH) the one hundred and twelve artificial afflictive obstructions
ཉོན-སྒྲིབ-ལྷན-སྐྱེས-བཅུ-དྲུག	(PH) sixteen innate afflictive obstructions
ཉོན-ཤེས	(PH) afflicted conscioesness
ཉུང	(PH) little; few
ཉུང-ཤས	(PH) a small amount
ཉུང-ཟད	(PH) few; very few
པ-ལ-བ	(PH) Parthian (i.e. Bactrian)
པ-ལ-ཤ	(PH) palāśa tree
པ-ལ-ཤའི-མེ-ཏོག	(PH) palāśa flower
པ-ཊ-རི-མོ	(PH) scrollwork patterns ("volutes")
པད-འབྱུང-ཡབ-ཡུམ	(PH) Padmasambhava and consort
པད-མའི-ངང-ཚུལ	(PH) [The one who is] the nature of the Lotus [epith. of Kamalaśīla]
པདམ	 (PH) lotus|(PH) lotus 
པདམ-འབྱུང-གནས	(PH) Padmasambhava
པདམ-བསྣམས	(PH) Padmapāṇi
པདམ-དཀར	(PH) white lotus
པདམ-གར-དབང	(PH) Avalokiteśvara / Hayagriva
པདམ-རྒྱས-པ	(PH) fully-blossomed lotus
པདམ-སམ-བྷ-ཝ	(PH) Padmasambhava
པདམ-སཾ-བྷ-ཝ	(PH) Padmasambhava
པདམའི-ངང-ཚུལ	(PH) [The one who is] the nature of the Lotus [epith. of Kamalaśīla]
པན-ཆེན-གྱི-ཡིག-ཆ	(PH) textbooks of Paṇ-chen [So-nam-drak-ba]
པན-ཞྭ	(PH) paṇḍita's hat; scholar's hat
པཎ-ཞྭ	(PH) paṇḍita's hat; scholar's hat
པན-ཞྭ-རྣ-རིང	(PH) paṇḍita's hat; scholar's hat
པཎཌི-ཏ	(PH) paṇḍita
པཎཌིཏ	(PH) paṇḍita
པར-འགྱའ	(PH) wisdom [arch. spelling]
ཕ	(PH) beyond; farther
ཕ-མྱེས	(PH) paternal ancestor(s)
ཕ-རོལ-ཚུ	(PH) the "opposite" bank [of a river]
ཕག	(PH) hidden
ཕག-མོ-གཞུང-དྲུག	(PH) six treatises on Vārāhī
ཕག-རྒོད	(PH) wild boar
ཕལ-ཆེར-མཚུངས-པ	(PH) mostly the same [way]
ཕལ-མོ-ཆེར-ན	(PH) for the most part
ཕམ-ཉེས	(PH) defeat; failure
ཕན-སེམས	(PH) benevolent intention
ཕན-ཚུན	(PH) opposite sides
ཕན-ཚུན-མཉེན	(PH) mutually agreeable
ཕར-ཕྱིན-ལྷག-ཚུལ-གྱི-ཁྱད-པར	(PH) the feature of a surpassing mode of perfection
ཕར-རྒྱབ-ན	(PH) beyond
ཕས-རྒོལ	(PH) arguments by others; false teachings; false teacher
ཕེ-རིང	(PH) foreign
ཕི-གླིང	(PH) European
ཕོ	(PH) male
ཕོ-བོ	(PH) stomach
ཕོ-བྲང	(PH) Palace
ཕོ-ལོང	(PH) stomach and large intestine
ཕོ-ལོང-བར	(PH) space between the stomach and large intestine
ཕོ-མོའི-མཚན-མ	(PH) male or female sex organs
ཕོད-ཅན	(PH) comet
ཕོད-ཕོད-པ	(PH) puffs; clouds; billows
ཕོན-ཐག	(PH) (leather) strap used to tie a bundle
ཕྲ-མ	(PH) gossip; rumor; lies
ཕྲ-རབ-ཀྱི-རྡུལ	(PH) subtle atoms; subtle particle
ཕྲ-རགས	(PH) coarseness and subtlety; coarse and subtle
ཕྲ-རྡུལ	(PH) subtle atoms; subtle particle
ཕྲག-དོག-ཉིད	(PH) jealousy
ཕྲན	(PH) small; minor; humble; we; us; [first person plural pronoun]
ཕྲེང	(PH) garland; rosary; halo; series
ཕྲེང-ཐང	(PH) streak; flash [of lightening]
ཕྲུག	(PH) child; young one
ཕུ-དུད	(PH) variegated
ཕུན-སུམ་	(PH) marvels
ཕུན-ཚོགས	(PH) marvels
ཕུང	(PH) mass; heap
ཕུང-གསུམ-པ	(PH) third category
ཕུང-པོ	(PH) mass; heap; totality
ཕྱག-བྲིས	(PH) letter; handwriting; handwritten [text]
ཕྱག-བྱ-བའི-འོས	(PH) worthy of homage
ཕྱག-བྱས-པ	(PH) attendant
ཕྱག-དར-ཁྲོད	(PH) a rubbish heap
ཕྱག-ན-པདམ	(PH) Padmapāṇi
ཕྱག-རྒྱ-མེད	(PH) sealed with a seal from the beginning
ཕྱག-རྒྱའི-མདུད	(PH) knotted seal
ཕྱེ-བ	(PH) opening; division; differentiation
ཕྱེ-བ-སོ-སོ	(PH) individual divisions
ཕྱེ-བ-སོ-སོའི-དོན	(PH) meaning of the individual divisions
ཕྱེ-མ	(PH) dust
ཕྱེ-ཤུལ	(PH) passageway
ཕྱི-དང-ནང-གི-བསྟན-པ	(PH) the teachings of Buddhists and Outsiders
ཕྱི-དབུགས	(PH) external breath
ཕྱི-དྲོའི-དུས	(PH) afternoon
ཕྱི-མིག	(PH) backwards
ཕྱི-ནང	(PH) Buddhist and non-Buddhist
ཕྱི-ནང-སྣོད-བཅུད	(PH) environment and [its] inhabitants (inner and outer)
ཕྱི-ངོས-སུ	(PH) facing outward
ཕྱི-རྒོལ	(PH) opponent; second party
ཕྱི-རོལ-དོན	(PH) external objects
ཕྱིའི-རྣམ-ཐར	(PH) exoteric biography; "outer" biography
ཕྱིར-འཚོང-གོང-ཚད	(PH) sales price
ཕྱིར-ལ་	(PH) moreover
ཕྱིར-མི-ལྡོག-པའི-བྱང-སེམས	(PH) irreversible bodhisattva
ཕྱིས	(PH) later; at later times
ཕྱིས-མྱོང-བར-འགྱུར-བ	(PH) experience in a later life
ཕྱིས-ཕྱིས	(PH) much later
ཕྱོགས	(PH) direction; portion
ཕྱོགས-བཅུ-ནམ-མཁའ	(PH) space in the ten directions
ཕྱོགས-ཀྱི-རྩ-བཞི	(PH) four cardinal directions
ཕྱོགས-ལྟར-སྣང	(PH) counterfeit thesis
ཕྱོགས-སྔ	(PH) opponent
ཕྱུག-རྫི	(PH) cowherd; cattle-keeper; herdsman
ཕྱྭ-སྨྲ-བ	(PH) Fatalist; Proponents of Predetermination
པྲ-སེན	(PH) mirror divination
པུས	(PH) knee
པུས-འོག	(PH) lower edge of the knee
པུས-མོ-གཡས-པའི-ལྷ-ང	(PH) bent right knee
ར	 (PH) goat|(PH) goat 
ར-བ	(PH) fence; courtyard
ར-ཕོ	(PH) goat
རབ-འབྱམས	(PH) countless; manifold; infinite
རབ-འབྱམས-མཁས-པ	(PH) countless scholars
རབ-འབྱམས-པ	(PH) countless; manifold; infinite
རབ-རྒྱན	(PH) [n. of calendrical cycle]
རབ-སྣང	(PH) brilliantly illuminated [things]
རབ-ཏུ-དང-བའི-ཡིད	(PH) very pure mind
རབ-ཏུ-སྣང-བ	(PH) brilliantly illuminated [things]
རབ-ཏུ-སྣང-བྱེད	(PH) Pramāsa [charnal ground]
རབ-ཏུ-ཟླུམ-པོ	(PH) completely round; perfectly round
རལ-གྲིའི-སོ	(PH) edge of a sword
རལ-པ	(PH) [lion's] crest hair; matted hair
རལ-པ-ཅན	 (PH) [lion's] crest hair|(PH) [King] Ralpajen 
རལ-པའི-ཐོད	(PH) crown of matted hair; matted crown
རང	(PH) it; itself
རང-འཁོར	(PH) its accompanier
རང-བཞིན	(PH) own nature; nature
རང-བཞིན-འཇམ-པོ	(PH) naturally smooth
རང-བཞིན-བརྒྱད-ཅུ	(PH) eighty instinctual natures
རང-བཞིན-གཅིག	(PH) same nature
རང-བཞིན-གྱིས-གྲུབ-པ	(PH) being intrinsically established; being inherently established; intrinsic establishment; inherent establishment
རང-བཞིན-མྱང-འདས	(PH) naturally passed beyond sorrow; natural nirvāṇa
རང-དང-སྣོད-བཅུད	(PH) oneself and the environment and [its] inhabitants
རང-དགའ-བ	(PH) ordinary
རང-གི-འཇུག-ཡུལ-གྱི-གཙོ-བོ	(PH) its principal object of engagement
རང-གི-འཁོར	(PH) its accompanier
རང-གི-བློ-ངོར	(PH) from one's own perspective
རང-གི-བརྗེད-བྱང	(PH) own reminder
རང-གི-བསྟན-བྱ	(PH) its indicated meaning
རང-གི-གསལ-བ	(PH) its own instances
རང-གི-ངོས-སྐལ-གྱི-སྒྲིབ	(PH) the corresponding obstructions
རང-གི-ངོས-སྐལ-གྱི-སྒྲིབ-གཉིས	(PH) the two corresponding obstructions
རང-གི-རིགས-ཅན	(PH) having its type
རང-གི-རིགས-ཡོད-པ	(PH) having its type
རང-གི-རིགས-ཡོད-པ-ཅན	(PH) having its type
རང-གི-སྡོད-ལུགས-གྱི-ངོས-ནས-གྲུབ-པ	(PH) establishment from the perspective of its own mode of subsistence
རང-གི-སྣང-བ	(PH) own appearing object
རང-གཞན-གྲུབ-མཐའ	(PH) the tenets of ourselves and others
རང-གཞན-ཐམས-ཅད	(PH) all [beings] — oneself and others
རང-མདོག	(PH) natural color
རང-ངོས	(PH) its own side
རང-ཉིད	(PH) oneself; that itself
རང-ཉིད-ལྷན-ཅིག-བྱེད-རྐྱེན	(PH) something's being a cooperating condition
རང-རྒྱལ-གྱི-རྣལ-འབྱོར-མངོན-སུམ	(PH) yogic direct perception [in the continuum] of a Pratyekabuddha
རང-རྒྱལ-གྱི-སྦྱོར-ལམ-དྲོད	(PH) Solitary Realizer heat path of preparation
རང-རྒྱལ-སློབ-པ	(PH) learner Solitary Realizer
རང-རྒྱུད-པ	(PH) Svātantrika; Proponents of the Autonomous [Syllogisms]
རང-རིག	(PH) self-cognizing [awareness]; self-knower
རང-རྣམ	(PH) autobiography
རང-ཡིད	(PH) subjective mind
རས-བཅོས-བུ-ཟུང	(PH) cotton cloth
རྡོ-འཇོག	(PH) Takṣaśilā
རྡོ-བསྲེགས	(PH) burning coals
རྡོ-རིལ	(PH) small stone
རྡོ-རྗེ-འཛིན	(PH) vajra-holder; tantric master
རྡོ-རྗེ-འཛིན-པ	 (PH) vajra-holder; tantric master|(PH) vajra holder 
རྡོ-རྗེ-ཆང-ཡབ-ཡུམ	(PH) Vajradhara and consort
རྡོ-རྗེ-དམ-ཚིག	(PH) vajrasamaya; vajra commitments
རྡོ-རྗེ-དབང-ཕྱུག	(PH) Vajra Lord
རྡོ-རྗེ-གཏུམ-པོ	(PH) ferocious vajra
རྡོ-རྗེ-ཁུ-ཚུར	(PH) vajra-fist [name of a mudrā]
རྡོ-རྗེ-ལྕགས-ཀྱུ	(PH) vajra claws
རྡོ-རྗེ-མི-ཕྱེད	(PH) indestructible vajra
རྡོ-རྗེ-ཉི-མ	(PH) Vajrasūrya
རྡོ-རྗེ-རྒྱལ-མཚན	(PH) Vajradhvaja[-sūtra]
རྡོ-རྗེའི-བརྟུལ-ཞུགས	(PH) vajra vows of conduct
རྡོ-རྗེའི-དམ-ཚིག	(PH) vajrasamaya; vajra commitments
རྡོག-པོ	(PH) a grain of corn
རྡོར-སེམས-ཡབ-ཡུམ	(PH) Vajrasattva and consort
རྡོས	(PH) corpulent; bloated; heavy and gross
རྡུལ	(PH) passions; ovum; menstrual blood
རྡུལ-དང-ལྡན-མ	(PH) ovulating woman
རྡུལ-ཕྲ	(PH) subtle atoms; subtle particle
རྡུལ-ཕྲ-མོ	(PH) subtle atoms; subtle particle
རྡུལ-ཕྲ-རབ	(PH) subtle atoms; subtle particle
རྡུལ-ཕྲན	(PH) atoms; particle
རྡུལ-ཕྲན-ཆ-ལྡན	(PH) particle with parts
རྡུལ-ཕྲན-ཆ-མེད	(PH) [generic] partless particle
རྡུལ-ཕྲན-ཕྲ-མོ	(PH) subtle atoms; subtle particle
རྡུལ-ཚོན	(PH) colored powder
རྡུལ-ཚུབ	(PH) Manchu queue [hairstyle]
རྫ-མཁན	(PH) potter
རྫས-འཛིན-རྟོག-པ	(PH) conception of the true existence of subjects (i.e., persons) as being substantially existent
རྫས-འཛིན-རྟོག-པ-དགུ	(PH) conception of the true existence of subjects (i.e.; persons) as being substantially existent
རྫས-གཅིག-པ	(PH) one substantial entity
རྫས-གཞན	(PH) different substantial entities
རྫས-ལྡོག	(PH) substantial and isolate [phenomena]
རྫས-རེ-རེ	(PH) single substantial entity
རྫས-རྒྱུན-ཕྱི-མ	(PH) subsequent continuation of a substantial entity
རྫི	 (PH) herder; supervisor; one who cares for; one who guides|(PH) breeze; wind 
རྫོགས-བྱང	(PH) complete enlightenment
རྫོགས-ལྡན	(PH) age of perfection [first of the four ages of the aeon]
རྫུ-འཕྲུལ-ཅན	(PH) possessing magical powers
རྫུན-དང-གཡོ-སྒྱུ	(PH) lies and deceit and guile
རྫུན-མཁན	(PH) liar
རེ	(PH) some; respectively
རེ-རེ	(PH) each
རེ-ཞིག	(PH) temporarily; for some time; initially
རྒ-བ	(PH) old age
རྒན	(PH) palate
རྒོད	(PH) excitement
རྒོད-པ-དང-འགྱོད-པ	(PH) excitement and contrition
རྒོལ-འཛིང	(PH) fighting
རྒོལ-བ-ངན-པ	(PH) evil opposition
རྒུད	(PH) trouble; misfortune
རྒུད-ཉམས	(PH) ruin; decline; deterioration
རྒུད-པ	(PH) trouble; misfortune
རྒྱ	(PH) Chinese; Indian; seal
རྒྱ-བྲིས-ཐང-ཀ	(PH) Chinese-style thangka
རྒྱ-ཆེ-གཏིང-ཟབ	(PH) vast and profound
རྒྱ-ཆེན	(PH) extensive; broad; great
རྒྱ-དམག	(PH) Chinese army
རྒྱ-ཁྱོན	(PH) area; extent
རྒྱ-ཁྱོན-ཆེ-བ	(PH) large extent
རྒྱ-མདུད	(PH) knotted seal
རྒྱ-ནད	(PH) syphilis
རྒྱ-སེར	(PH) Russia
རྒྱ-སྤོས-མེ-ཏོག	(PH) Chinese incense flower
རྒྱབ	(PH) bottom
རྒྱབ-འབོལ	(PH) back cushion
རྒྱབ-ལོག	(PH) behind
རྒྱབ-ན	(PH) behind
རྒྱབ-རྫི	(PH) supervisor
རྒྱབ-སྙེ	(PH) inner backrest
རྒྱགས	(PH) haughtiness
རྒྱལ	(PH) [the Indian month of] Puṣya
རྒྱལ-བའི-རྒྱལ-ཚབ	(PH) the regent of the Conqueror
རྒྱལ-བློན	(PH) king and his ministers
རྒྱལ-བུ-རྒྱལ-བྱེད	(PH) Jetavana
རྒྱལ-ཆེན-རྣམ-ཐོས-ཀྱི-བུ	(PH) the great king Vaiśravana
རྒྱལ-དབང	(PH) Lord of Conquerors
རྒྱལ-དཔོག-པ	(PH) Jaimini
རྒྱལ-ཀུན-ཡབ-གཅིག	(PH) the only father of all the Buddhas
རྒྱལ-པོ-བརྩེ-བ-མེད-པ-དྲག-པོས-བྱིན	(PH) the merciless king Ugradatta
རྒྱལ-པོ-དམག-བརྒྱ-བ	(PH) King Śatānīka [a Licchavi]
རྒྱལ-པོ-དམག-བརྒྱ-པ	(PH) King Śatānīka [a Licchavi]
རྒྱལ-པོ-དྲག-པོས-བྱིན	(PH) King Ugradatta
རྒྱལ-པོ-གཟུགས-ཅན-སྙིང-པོ	(PH) King Bimbisāra
རྒྱལ-པོའི-ཁབ	(PH) Rājagṛha
རྒྱལ-རྒྱུད	(PH) royal lineage
རྒྱལ-ས	(PH) kingdom; capital city
རྒྱལ-སྲས-རྟག-ཏུ-ངུ	(PH) [Bodhisattva] Sadaprarudita
རྒྱལ-ཚབ	(PH) Maitreya [epithet of]; status as crown prince; royal inheritance; Gyel-tsap Dar-ma-rin-chen (rgyal tshab dar ma rin chen, 1364-1432)
རྒྱལ-ཚབ-དམ-པ	(PH) sublime regent
རྒྱལ-ཟླ	(PH) the twelfth month
རྒྱང	(PH) far away
རྒྱང-མ	(PH) distance; far away
རྒྱས-ལྡན	(PH) Puṣkaravatī (ancient capital of Gandhāra)
རྒྱུ	(PH) cause
རྒྱུ-པ-མེད-པའི-ཚིག	(PH) conventional expression
རྒྱུ-རྡོ-རྗེ-འཛིན-པ	(PH) causal vajra-holder
རྒྱུད	(PH) lineage; tantra
རྒྱུན	(PH) continuum; continuation; stream; current; line
རྒྱུན-གྱི-ཡི-དམ	(PH) personal tutelary deity
རྒྱུན-མཐའི-བར-ཆད-མེད-ལམ	(PH) the uninterrupted path of the end of the continuum
རྒྱུན-ཕྱི-མ	(PH) subsequent continuation
རྒྱུན-རིང	(PH) long time; long duration
རྒྱུན-རིང-པོ	(PH) (for) a long time
རྒྱུས	(PH) familiar
རི	(PH) mountain
རི-བོ-འབིགས-བྱེད	(PH) Vindhya Mountain range
རི-བོ-རྩེ-ལྔ	(PH) the Five-Peaked Mountain (Wu-t'ai-shan)
རི-བྲགས-པ	(PH) bandits
རི-དེའུ	(PH) small hill
རི-དྭགས-ཀྱི-གནས	(PH) Deer Park
རི-དྭགས-རྒྱུ-བའི-གནས	(PH) Deer Park
རི-དྭགས-སྤགས-པ	(PH) antelope skin
རི-ཁ-བ-ཅན	(PH) Mountainous Land of Snows (Tibet)
རི-ལྡིང	(PH) mountain slope
རི-མོ-མཁན	(PH) artist
རི-མོའི-དཁྱིལ-འཁོར	(PH) painted maṇḍala
རི-ཕུག	(PH) mountain cave
རི-རྒྱུད	(PH) mountain range
རི-སུལ-གྱི-ཕུག	(PH) mountan cave
རིའི-ཕུག	(PH) mountain cave
རིག	(PH) knower; knowledge; awareness; thoughts
རིག-པ	(PH) knower; knowledge; awareness; thoughts
རིག-པའི-བརྟུལ-ཞུགས	(PH) proper religious observances
རིག-པའི-ཆོས-གྲྭ-ཆེན-པོ	(PH) the great Vidyadharma college [at Nalendra]
རིགས	 (PH) type; kind; class; lineage; legacy; clan; family|(PH) type; kind; class; lineage; legacy; clan; family 
རིགས-མཐའ-དག	(PH) all types
རིགས-ངན-སྨྱིག-མ-མཁན	(PH) founder of a lineage of the lowest of outcastes
རིགས-ངེས-བྱང-སེམས	(PH) bodhisattva firm in their lineage
རིགས-པ-མདོར-བསྡུས	(PH) brief reasonings
རིགས-ཐིགས	(PH) [Dharmakīrti's] ″Drop of Reasonings″
རིགས-ཡོད-པ-ཅན	(PH) [that] which has a type
རིམ-བཞིན	(PH) in stages; in sequence
རིམ-པར-ཕྱེ-བ	(PH) section
རིམས	(PH) disease
རིན-ཆེན	(PH) precious; jewel; monetary offering
རིན-ཆེན-སྣ-ལྔ	(PH) five various precious things
རིན-ཆེན-ཏོག	(PH) Ratnaketu
རིན-ཆེན-ཏོག་	(PH) Ratnaketu
རིན-པོ-ཆེ-སྣ-ལྔ	(PH) various five precious substances
རིང-བའི-རྒྱུ	(PH) distant cause
རིང-བསྲེལ-མང	(PH) many relics
རིང-ཆ	(PH) long part; long vowel
རིང-ཞིག	(PH) slowly; a while; a short time
རིང-ཞིག-ཏུ	(PH) for a long time
རིས-གཡས-སུ-འཁྱིལ-བའི-དུང	(PH) clockwise spiraling conch shell
རིས-ཡིན	(PH) section
རྗེ-བཙུན	(PH) venerable
རྗེ-བཙུན-བླ-མ	(PH) venerable teacher
རྗེ-སུ-དྲན-པ-དྲུག	(PH) six recollections
རྗེ-ཐམས-ཅད-མཁྱེན-པ	(PH) Omniscient Lord
རྗེ-ཡབ-སྲས-བཞི	(PH) Tsong-kha-pa and his three disciples; Rgyal-tshab; Mkhas-grub; and 'Dul-'dzin Grags-pa-rgyal-mtshan
རྗེ-ཡབ-སྲས-གསུམ	(PH) Tsong-kha-pa and his two disciples; Rgyal-tshab and Mkhas-grub
རྗེའུའི-རིགས	(PH) merchant/ bourgeois class
རྗེན-ཆར	(PH) nakedly
རྗེས-འཇུག	(PH) follower; followers
རྗེས-བཞིན-དུ	(PH) accordingly; after a while
རྗེས-བཟོད-བཞི	(PH) four subsequent forbearance
རྗེས-དཔག-ཚད-མ	(PH) inferential valid cognition
རྗེས-མི-ལ	(PH) Lord Milarepa
རྗེས-སུ-འབྲེལ-པ	(PH) indicatory phonemes [in Paninian grammar]
རྗེས-སུ-དྲན-པ-བཅུ	(PH) ten mindfulnesses
རྗེས-སུ-ཐུགས-བརྩེ-བ	(PH) mind of exceptional loving compassion
རྗེས-ཐོབ-རྒྱ-ཡན-པ	(PH) dispersed state subsequent [to meditative equipoise]
རྗེས-ཐོབ-ཏུ-ངེས-ཤེས-འདྲེན-གྱི-ཁྱད-པར	(PH) the feature of the mode of inducing an ascertaining consciousness in states subsequent to meditative equipoise
རྐན	 (PH) palate | (PH) tongue (jihva)|(PH) hump of the shoulders (kākuda) 
རྐང-རྟེན	(PH) portable stool [used to aid in dismounting from a horse or vehicle]
རྐྱང-པ	(PH) whole; complete; totality
རྐྱེན-འདི-པ-ཙམ-ཉིད	(PH) having just these conditions
རྐྱེན-བུ	(PH) reason
རྐྱེན-ཉིད-འདི-པ-ཙམ	(PH) mere state of conditionality
རླབས-ཕྲེང	(PH) successive waves
རླངས-པ	(PH) Vaśpa (p.n. monk & disciple of the Buddha)
རློན	(PH) moist; fresh
རླུབས	(PH) pit; abyss; ditch
རླུང	(PH) wind; wind
རླུང-འཚུབ	(PH) whirlwind; violent storm
རླུང-ལུས	(PH) wind-body
རླུང-རྒྱུ-བ	(PH) moving wind
རྨ-བྱ-ཆེན-མོ	(PH) Mahāmāyūrī
རྨ-བྱའི-ཚོགས-ཅན	(PH) ″Group of Peacocks″ (n. of a forest in S. Tibet)
རྨད	(PH) marvelous; marvelous [thing]
རྨད-བྱུང	(PH) marvelous
རྨངས-མོ	(PH) scum
རྨི-ལམ-གྱི-རྟགས	(PH) dream signs
རྨི-ལམ-གྱི-ཤེས-པ	(PH) a dream consciousness
རྨི-ལམ-ལུས	(PH) dream-body
རྨི-ལྟས	(PH) dream signs
རྨོངས-བྱེད-མ	(PH) Mohani
རྨོངས-ཆེན	(PH) great fool
རྨོངས-མེད	(PH) non-delusion
རྨུགས	(PH) lethargy
རྣ-བ-མ-ཕུག-པ	(PH) Aviddhakarṇa (p.n.; Nyāya/Carvāka author)
རྣ-ནག-མ	(PH) goddess of misfortune
རྣལ-འབྱོར-མངོན-སུམ-ཚད-མ	(PH) valid yogic perception
རྣལ-འབྱོར-པའི-བློ-ངོར	(PH) from the perspective of a yogi
རྣལ-འབྱོར-སྤྱོད-པ	(PH) Yogācāra; Yogic-Practice [School]
རྣལ-འབྱོར-སྤྱོད-པ-བ-རྣམ-རྫུན-པ	(PH) Yogācāra False Aspectarian [School]
རྣལ-འབྱོར-སྤྱོད-པ-དབུ-མ	(PH) Yogācāra-Svātantrika-Mādhyamika; Yogic Practice Middle Way Autonomy [School]
རྣལ-འབྱོར-སྤྱོད-པའི-དབུ-མ	(PH) Yogācāra-Svātantrika-Madhyamaka; Yogic Practice Middle Way Autonomy School
རྣལ-འབྱོར-སྤྱོད-པའི-དབུ-མ-པ	(PH) Yogācāra-Madhyamaka; Yogic Practice Middle Way [School]
རྣལ-འབྱོར-སྤྱོད-པའི-དབུ-མ-རང-རྒྱུད-པ	(PH) Yogācāra-Svātantrika-Mādhyamika; Yogic Practice Middle Way Autonomy [School]
རྣལ-འབྱོར-སྤྱོད-པའི-དབུ-མ-རང-རྒྱུད-པའི-ལུགས	(PH) Yogācāra-Svātantrika-Mādhyamika School; Yogic Practice Middle Way Autonomy School
རྣལ-འབྱོར-སྤྱོད-པའི-དབུ-མ-རྒྱུད-པ	(PH) Yogācāra-Madhyamaka lineage; Yogic Practice Middle Way lineage
རྣལ-བཞིན	(PH) restfully; soundly
རྣལ-ལམ	(PH) yogic dream
རྣམ	(PH) kind; type; aspect; form
རྣམ-འདྲེན-བཞི-པ	(PH) fourth guide [Śākyamuni]
རྣམ-འདྲེན-ལྔ-པ	(PH) fifth Guide [Maitreya]
རྣམ-འདྲེན-སྟོང-རྩ	(PH) one thousand guides [buddhas]
རྣམ-འགྲེལ	(PH) commentary
རྣམ-བཅས	(PH) aspectually mediated
རྣམ-བརྫུན-དྲི-བཅས-པ	(PH) Tainted False Aspectarian
རྣམ-བརྫུན-དྲི-མེད	(PH) Non-Tainted False Aspectarian
རྣམ-བརྫུན-དྲི-མེད-པ	(PH) Non-Tainted False Aspectarian
རྣམ-བརྫུན-པ	(PH) False Aspectarian
རྣམ-བཞག-རིམ-པ	(PH) [Nāgabodhi's] Ordered Stages [of the Guhyasamāja Sādhana]
རྣམ-དག-ཞིང	(PH) Pure Land
རྣམ-དཀར	(PH) wholesome; wholesome [things]
རྣམ-གནོན-ངང-ཚུལ	(PH) Vikramaśīla
རྣམ-གནོན-ཉི-མ	(PH) [King] Vikramāditya
རྣམ-གནོན-ཚུལ	(PH) Vikramaśīla
རྣམ-གྲོལ-ལམ-སྐོར-དགུ	(PH) nine cycles of paths of release
རྣམ-གཟིགས	(PH) the Bodhisattva Vipaśyin (who became the Buddha Śākyamuni)
རྣམ-མང	(PH) manifold; many aspects
རྣམ-མཁྱེན-སྐད-ཅིག-དང-པོ	(PH) first moment of an exalted knower of all aspects
རྣམ-པ-མང-པོ	(PH) many aspects
རྣམ-པ-ངུར-སྨྲིག	(PH) saffron aspect [i.e.; Buddhist monk]
རྣམ-པར-འགྱུར-བ-ཅན	(PH) activity
རྣམ-པར-འགྱུར-བ-ཅན-གྱི-ང-རྒྱལ	(PH) activity-dominated I-principal
རྣམ-པར-འཇུག-པ	(PH) Rakṣāsas
རྣམ-པར-དག-པ-གཞན-གྱི-དབང-ཉིད	(PH) other-powered purity
རྣམ-པར-དཀར-བ	(PH) wholesome [things]
རྣམ-པར-དཔྱད-པ-པོ	(PH) one who analyzes
རྣམ-པར-རིག-པ-དང-ཐ-སྙད	(PH) what is conventionally known
རྣམ-པར-སྦྱང-བར-བྱ-བ	(PH) object purified
རྣམ-པར-ཐར-པ-གསུམ	(PH) the three types of complete liberation [signlessness; wishlessness; 
རྣམ-པར-ཐར-པ-ཞལ-གསུངས-མ	(PH) autobiography
རྣམ-རྫུན-པ	(PH) False Aspectarian
རྣམ-རིག-པ	(PH) Proponent of the Ideation-Only (vijñapti-matra) School
རྣམ-རིག-པའི-ལུགས	(PH) Ideation-Only (vijñapti-matra) School
རྣམ-སྦྱར	(PH) robe
རྣམ-སྨིན-གྱི-སྐྱེ-བ-ལེན-ཚུལ-གྱི-ཁྱད-པར	(PH) the feature of the mode of taking fruitional rebirth
རྣམ-སྣང-གི-སྒོ	(PH) door of Vairocana
རྔམས-བརྗིད-དུར-ཁྲོད-རོལ-པའི-ཆས	(PH) frightful attire of a charnel ground dweller
རྔོག-ལོ-ཙཱ-བ-བློ-ལྡན-ཤེས-རབ	(PH) the translater; Ngok Lo-den-shay-rap (1059-1109)
རྔུལ	(PH) sweat
རྙེད-བཀུར	(PH) wealth and respect
རྙེད-པ-དང-བཀུར-སྟི	(PH) wealth and respect
རྙེད-པ-དང-བཀུར-སྟིས	(PH) wealth and respect
རྙིང-བ	(PH) old
རྙིང-ཤོས	(PH) most ancient
རོ	(PH) quality; corpse; residue; [terminating particle]
རོ-ཙ-བར-བྱ-བ	(PH) restoring virility
རོགས	(PH) assistance
རོལ-མོ	 (PH) Gandharva | (PH) musical instrument|(PH) actor; dancer 
རྟ-རྫི	(PH) horse-minder; one who tends horses
རྟག	(PH) eternal; perpetual
རྟག-བརྟན-གྱི-སྙིང-པོ	(PH) permanent, stable essence
རྟག-དངོས-ཐམས-ཅད	(PH) all permanent phenomena and functioning things
རྟག-པ-མ-ཡིན-པ	(PH) non-permanent phenomenon
རྟག-ཏུ-ངུ	(PH) [Bodhisattva] Sadaprarudita
རྟག-ཏུ-སྡོམ	(PH) maintained vow
རྟགས	(PH) reason; sign
རྟགས-ཀྱི-ཚུལ-གསུམ	(PH) three-fold proof
རྟགས-ཕྱི-མ	(PH) latter reason
རྟགས-སྔ-ཕྱི	(PH) former and latter reasons
རྟགས-ཙམ	(PH) mere sign; slightest sign
རྟགས-ཙམ-འཛིན-པའི-དུས	(PH) the [degenerate] time of merely holding onto the sign [of wearing robes as being Buddhist]
རྟེན	(PH) foundation; stable basis; sanctuaries
རྟེན-དང-བརྟེན-པ	(PH) support and supported; residence and resident
རྟེན-གཞི	(PH) basis; foundation
རྟེན-པ	(PH) foundation; support; stable basis; base
རྟེན-རྟགས-ཡང-དག	(PH) correct sign which is its basis
རྟིང	(PH) bottom; end; after; later
རྟིང-པ	(PH) later; subsequent; next; heel
རྟོག	(PH) investigation
རྟོག-འགྱུ	(PH) fleeting thoughts
རྟོག-མེད	 (PH) non-conceptual|(PH) non-conceptual 
རྟོག-མེད-དུ-གྱུར-པའི-མངོན-སུམ-ཚད-མ	(PH) non-conceptual valid perception
རྟོག-མངོན-འགྱུར	(PH) manifest conception
རྟོག-པ-དང-རྟོག-མེད-གཉིས	(PH) both conceptual and nonconceptual
རྟོག-པ-དང-རྟོག-མེད-གཉིས-ཀ	(PH) both conceptual and nonconceptual
རྟོག-པ-ཁོ-ན	(PH) only a conceptual consciousness
རྟོག-པར-གྱུར-པའི-མངོན-སུམ-ཚད-མ	(PH) conceptual valid perception
རྩ	(PH) channel
རྩ-འདབ-བཞི	(PH) four channel-petals
རྩ-ལྟུང-བཞི	(PH) four root infractions [of monks' vows]
རྩ-རྟགས	(PH) main reason
རྩབ-མོ	(PH) acidulated rice-water
རྩེ	(PH) top floor; top storey; peak
རྩེ-གཅིག-མཉམ-པ	(PH) single-pointed meditative equanimity
རྩེ-ཕྱག	(PH) [Potala] Treasurer
རྩེ-ཤོད	(PH) court; royal court
རྩེད-འཇོ	(PH) public amusement; public display
རྩི	(PH) elixir; remedy
རྩི-ཤིང	(PH) a board or slate for counting and writing figures upon
རྩིབ-ལོགས-སྐྱེས	(PH) 'born fron the side of the torso'
རྩིབས-སྟོང	(PH) thousand spokes
རྩིག	(PH) wall
རྩིག-པ-སྣ-ལྔ	(PH) variegated five-fold wall
རྩིག-པའི-འགྲམ	(PH) foot of the wall
རྩོག-རྩོག-པ	(PH) sprawled out; spread out; scattered
རྩོམ-གདན	(PH) draft
རྩོན-འགྲུས	(PH) effort
རྩུབ	(PH) rough
རྟུལ	(PH) dull; weak; inferior
རུ	(PH) [accusative, adverbial accusative, dative, and locative particle]; section; division; part; horn
རཱུ-པ-ཏི	(PH) Rūpati [n. of a minor king who fought with the Kauravas]
རུ-ཏྲ	(PH) Rudra
རུམ	(PH) gestational heat
རུང-ཚོན	(PH) suitable color
རུས	(PH) lineage; family
རུས-བུ	(PH) bone
རུས-གཟེབ	(PH) skeleton
རུས-པའི-འཁྲུལ-འཁོར	(PH) pelvic girdle
རྭ	(PH) fence
ས-འཚམས	(PH) boundaries
ས-བཅུ-པ-བ	(PH) a tenth grounder
ས-བདུན-པ-བ	(PH) a seventh grounder
ས-བརྒྱད-པ-བ	(PH) an eighth grounder
ས-བསྲེགས	(PH) burning ground
ས-བཏགས-པ-བ	(PH) imputed ground
ས-བཞི-བ	(PH) the fourth ground/level
ས-བཞི-པ-བ	(PH) a fourth grounder
ས-ཆེན	(PH) great ground; vast earth
ས-ཆེན-ཁྱོན	(PH) extent of this vast earth
ས-ཆེན-པོ	(PH) great ground; vast earth
ས-ཆུ-མེ	(PH) earth; water; and fire
ས-ཆུ-མེ-རླུང-ནམ-མཁའ	(PH) earth; water; fire; wind; and space
ས-དང-པོ-པ	(PH) a first grounder
ས-དགུ-བ	(PH) the ninth ground
ས-དགུ-པ-བ	(PH) a ninth grounder
ས-དྲུག-པ	(PH) the sixth ground
ས-དྲུག-པ-བ	(PH) a sixth grounder
ས-གཉིས-པ-བ	(PH) a second grounder
ས-གསུམ-པ	(PH) third ground/level
ས-གསུམ-པ-བ	(PH) a third grounder
ས-གཞི	(PH) place; site; base
ས-གཞི-དག	(PH) all places; surface of the earth
ས-གཞི-གཙང-མ	(PH) pure ground
སཱ-ལའི-དབང-པོའི-རྒྱལ-པོ-འབྱུང-བ	(PH) Sālendra-rājācāra
ས-ལྔ-བ	(PH) fifth ground/level
ས-ལྔ-པ-བ	(PH) a fifth grounder
ས-མང-པོ-པ	(PH) 'Many Levels' [chapter of Asaṅga's Actuality of the Grounds]
ས-སྐྱ-པ	(PH) Sakyapa (i.e.; Sakya Paṇḍita)
ས-ཡི-སྟེང	(PH) on the ground; on the earth
སད	(PH) frost
སད-ན-ལེགས	(PH) Se-na-lek [Jing-yön; the regal name of Tri-de-song-tsen]
སད-སེར	(PH) frost and hail
སག-སྒམ	(PH) leather box
སག-ཤུབས-མ	(PH) leather case
སམ-ཊ	(PH) message board
སངས-རྒྱས-འཕྲིན-ལས-ཆེན-པོ	(PH) the great activities of a Buddha
སངས-རྒྱས-བཀའ	(PH) Buddha-word
སངས-རྒྱས-ཀྱི-རང-གི-ངོ-བོ	(PH) Buddha-nature
སར-པ	(PH) new
སྦ-བཞེད	(PH) Affirmation of sBa (sba bzhed)
སྦོམ-པོ	(PH) thick; thickness
སྦྲ-སྟོད-ཚལ	(PH) upper Dra-tsal [region in Tibet]
སྦྲང-མོ	(PH) beggar-woman
སྦྲུལ-འཚོང	(PH) snake-merchant; prostitute
སྦྲུལ-གདུག	(PH) poisonous snake
སྦྲུལ-ཤད	(PH) ornamental 'shay' mark
སྦུབས-སྟོང	(PH) cavity; empty place
སྦྱིན-བདག	(PH) patron; benefactor; sponsor
སྦྱིན-པའི-བདག-པོ	(PH) patron; benefactor; sponsor
སྦྱོར-བ	(PH) application; exertion
སྡེ	(PH) set; school; faction; [rhetorical continuative particle]
སྡེབ-སྦྱོར	(PH) composition; formal stylistic writing
སྡེར-མོ	(PH) claw(s)
སྡིག-བློན	(PH) evil minister; poisonous advisor
སྡིག-ལྟུང	(PH) ethical transgressions and infractions [of vows]
སྡིག-པ	(PH) ethical transgression; negative action
སྡིག-སྒྲིབ	(PH) ethical transgressions and obstructions
སྡོད-ས	(PH) residence
སྡོད-སའི-སྤྱི-ཁང	(PH) communal residence hall
སྡོང-པོ-བཀོད-པ-ཡི-མདོ	(PH) the Array of Stalks Sūtra [gandhavuhya-sūtra: ch. 45 of Flower Ornament Sutra (avatāṃśaka-sūtra)]
སྡུད-པར-བྱེད-པ	(PH) compiler
སྡུག-བསྔལ-གྱི-རྩ-བ་	(PH) root of suffering
སྡུག-བསྔལ-མེ	(PH) fires of suffering
སྡུག-བསྔལ-མེ-ཆེན	(PH) great fires of suffering
སྡུག-བསྔལ-མཐོང-སྤང-ཉོན-མོངས-བཅུ	(PH) ten afflictions to be abandoned by the path of seeing [related to the Noble Truth of] Suffering
སྡུག-གུ	(PH) splendor
སྡུག-པ	(PH) attractive; nice; beautiful; beloved; spouse
སེམས	 (PH) mind; aspiration; intention|(PH) mind; aspiration; intention 
སེམས-བསྐྱེད	(PH) generating the mind [of enlightenment] (bodhicitta); (altruistic) mind-generation
སེམས-བྱུང-དགེ-བ-བཅུ-གཅིག	(PH) eleven virtuous mental factors
སེམས-ཅན-ནད-པ	(PH) sentient beings who are ill
སེམས-ཅན-ངན-པ	(PH) bad sentient being
སེམས-དཔའ	(PH) being; male [bodhi]sattva
སེམས-དཔའ-སུམ-བརྩེགས	(PH) three stacked beings [jñānasattva; samayasattva; & samādhisattva]
སེམས-གཡེང	(PH) mental distraction
སེམས-མཆོག	(PH) supreme mind [of enlightenment]; supreme bodhicitta
སེམས-ངན-པ	(PH) bad consciousness
སེམས-རྒོད	(PH) overly excited mind
སེམས-ཤིན-སྦྱངས	(PH) mental pliancy
སེམས-སྐྱོ	(PH) somber
སེམས-ཙམ-གྱི-སྲོལ	(PH) system of Mind-Only
སེམས-ཙམ-རྣམ-བདེན-པའི-ལུགས	(PH) the system of the Mind Only True Aspectarians
སེན	(PH) nail; fingernail; toenail
སེན-མོ	(PH) little piece
སེང-གེ-རྩལ	(PH) Siṃha-vikrama
སེང-གེའི-རྩལ-ཀྱིས-མངོན-པར-བསྒྲག-པའི-སྒྲ	(PH) Siṃha-vikrama
སེང-ཁྲི-པད-མ-ཉི-ཟླ	(PH) lion throne; lotus-; sun-; and moon-[disks]
སེངགེ	(PH) lion
སེངགེ-བཙན-པོ	(PH) [Tang dynasty Chinese Emperor] Taizong
སེར-ཁ	(PH) crack; split; cleft
སེར-ཁ-མེད-པ	(PH) unsplit
སེར-ཤས	(PH) yellowish
སེར-ཤས-ཅུང	(PH) slightly yellowish
སེར-སྐྱ	(PH) ordained and lay people
སེར-སྐྱའི-གཞི	(PH) Kapilavastu
སྒལ-གཞུང	(PH) backbone; spine
སྒང	(PH) period
སྒང-ཤོངས	(PH) ridges and valleys
སྒེག-པ	 (PH) playful; charming|(PH) mesmerizing (one of nine moods of dance) 
སྒོ	(PH) door
སྒོ-བ-ཡབ-ཡུམ	(PH) gate keepers and consorts
སྒོ-དྲུང-དུ	(PH) at/to the gate
སྒོ-གཉེར	(PH) responsibilities
སྒོ-ཁྱིམ	(PH) arched niche
སྒོ-ནས	(PH) from the point of view (of); through; by way of
སྒོམ-བྱུང-གི-མྱོང-བ	(PH) experience that is a state arisen from meditation
སྒོམ-ལམ-བར-ཆད-མེད-ལམ-བཅུ-གཅིག	(PH) the eleven uninterrupted paths of the path of meditation
སྒོམ-ལམ-སྐོར-དགུ	(PH) nine cycles of the path of meditation
སྒོམ-སྤང-ཉོན-མོངས	(PH) the afflictions that are to be abandoned by the path of meditation
སྒོམ-སྤང-ཉོན-མོངས-ཆེན-པོའི-ཆེན-པོ	(PH) the great of the great afflictions that are to be abandoned by the path of meditation
སྒོམ-སྤང-ཉོན-སྒྲིབ	(PH) the afflictive obstructions that are to be abandoned by the path of meditation
སྒོམ-སྤང-ཤེས-སྒྲིབ	(PH) the obstructions to omniscience that are to be abandoned by the path of meditation
སྒོམ-སྤང-ཤེས-སྒྲིབ-ཆེན-པོའི-ཆེན-པོ	(PH) the great of the great obstructions to omniscience that are to be abandoned by the path of meditation
སྒོམ-སྤང-སྐོར-བཅུ-གཅིག	(PH) the eleven cycles of the objects to be abandoned by the path of meditation
སྒྲ	(PH) grammar
སྒྲ-འཇུག-གཞི	(PH) basis of application of terms
སྒྲ-ཆེན-པོ	(PH) Mahānāda; Mahārāva
སྒྲ-དོན	(PH) object [indicated by] words
སྒྲ-གཞི	(PH) referent basis; basis of the term
སྒྲ-ཇི-བཞིན-དུ	(PH) literally
སྒྲ-མདོ	(PH) grammar treatise
སྒྲ-མི-རྟག-པ-ཆོས-ཅན	(PH) the subject — sound's [being] impermanent
སྒྲ-མི-སྙན	(PH) unpleasant sound
སྒྲ-མི-སྙན-པའི-མི	(PH) people of Uttarakuru (northern continent)
སྒྲས-བརྗོད-རིགས	(PH) terminology
སྒྲིབ-གྱོགས	(PH) [smoke-] screen
སྒྲིབ-པའི-མུན-སྟུག	(PH) dense darkness of obscuration
སྒྲིབས-པ-ལྔ	(PH) five obstructions
སྒྲིག	(PH) alignment; accord
སྒྲིམ-སྒྲིམ-པོ	(PH) fixed tight
སྒྲུབ-པ-གཉིས	(PH) the two achievements
སྒྲུབ-པའི-ནུས-པ	(PH) capacity for achieving
སྒྲུབ-པའི-ཡན-ལག-མི-བརྗོད-པ	(PH) stating what is not the element of a means of proof; stating what is not the factor of proof; stating what does not have proof as the factor; not stating the factor of proof; not stating the element of a means of proof
སྒྲུབ-ཐབས	(PH) means of achievement
སྒྲུང-པ	(PH) story teller
སྒྲུང-ཡིག	(PH) folk tale; folkstory
སྒྱོགས-རྡོ	(PH) boulder
སྒྱུ-འཕྲུལ-དྲྭ-བ	(PH) net of illusory emanations
སྒྱུ-འཕྲུལ-གར	(PH) illusory drama; magical drama
སྒྱུ-འཕྲུལ-རྭ-བའི-གར	(PH) the web of magical display
སྒྱུ-མ	(PH) illusory; magical; magician's illusion
སྒྱུ-མ-བྱེད-པ-མཁས-པ	(PH) a master magician
སྒྱུ-མ-བྱེད-པ-ཉེ-གནས	(PH) an apprentice magician
སྒྱུ-མའི-ནོར	(PH) illusory wealth
སྒྱུ-མའི-ཏིང-འཛིན	(PH) samādhi of illusion; samādhi [that perceives all as an] illusion
སྒྱུ-རྩལ-འཇིག-རྟེན-པ	(PH) the [sixty-four] worldy arts
ཤ	(PH) body
ཤ-དཀར	(PH) light flesh colour
ཤ-དཀར-གཡའ-རྩི	(PH) flesh-colored rust varnish
ཤཱ-ར-དྭ-ཏིའི-བུ	(PH) Śāriputra
ཤཱ-ར-དྭཏིའི-བུ	(PH) Śāriputra
ཤ-རྡོག	(PH) chunk of flesh
ཤཱ-རིའི-སྲས-པོ	(PH) Śāriputra
ཤ-རློན	(PH) fresh meat
ཤ-སྦྲང	(PH) biting insects
ཤ-སྟག	(PH) only; simply; merely
ཤ-སྟག-དུ	(PH) only; simply; merely
ཤ-ཐང	(PH) exhaustion
ཤ-ཚུགས-ཅན	(PH) fleshly appearance
ཤད	(PH) [punctuation mark]
ཤད-མ	(PH) comb
ཤཱཀྱ	(PH) Śākya
ཤཱཀྱ-མུ-ནེ	(PH) Śākyamuni
ཤཱཀྱའི-བཙུན-པ	(PH) Buddhist monk; (lit.) venerable one in the lineage of Śākyamuni
ཤལ-མ-རི	(PH) Mountain of Iron Weapons [Hell]
ཤན-ཅིག-བྱེད-རྐྱེན	(PH) cooperative condition
ཤན-ཁ-བ	(PH) Shankawa; [person from Shanka district]
ཤངས-ཤངས	(PH) bird-men
ཤངས-ཚ	(PH) conch shell
ཤར-བ	(PH) dawn; appearance
ཤར-ཆོས	(PH) Eastern Dharma [Successor to the Throne of Ganden]
ཤར-གྱི-སུམ-སྐོར-མ	(PH) ″triple-circle″ eastern [front] channel at the heart
ཤར-ངོས	(PH) eastern side; eastern face
ཤེལ-གྱི-ས-གཞི	(PH) ground of inlaid crystal
ཤེལ-ཕྲེང	(PH) crystal rosary
ཤེས-ཉོན-སྒྲིབ-པ	(PH) afflictive obstructions and obstructions to omniscience
ཤེས-པ	(PH) knowledge
ཤེས-པ-བརྒྱད	(PH) the eight knowledges [of the path of seeing]
ཤེས-པ-གློ-བུར-པ	(PH) an adventitious consciousness
ཤེས-རབ-དབང-བསྐུར	(PH) wisdom initiation
ཤེས-རབ-མཚོན	(PH) weapon of wisdom
ཤེས-རབ-ཕ-རོལ-ཕྱིན-སྦྱོར	(PH) application of the perfection of wisdom
ཤེས-སྒྲིབ-ལྷན-སྐྱེས-བརྒྱ-དང-བརྒྱད	(PH) the one hundred and eight innate obstructions to omniscience
ཤེས-སྒྲིབ-ལྷན-སྐྱེས-སུམ-ཅུ-རྩ-དྲུག	(PH) the thirty-six innate obstructions to omniscience
ཤེས-སྒྲིབ-རགས-པ	(PH) coarse obstructions to omniscience
ཤིག	(PH) a; an; louse; lice
ཤིན-ཏུ-བབ-ཅོལ	(PH) very confused
ཤིན-ཏུ-བདེན	(PH) very true
ཤིན-ཏུ-བྱིངས	(PH) majority
ཤིན-ཏུ-ཆེ	(PH) most; exceptional
ཤིན-ཏུ-དང-བ	(PH) very clear; utterly pure
ཤིན-ཏུ-རྩིངས-པ	(PH) very rough
ཤིང	(PH) wood; tree; stick
ཤིང-ཁུན	(PH) Liangzhou (涼州)
ཤིང-ལྗོན	(PH) tree
ཤིང-རྟ-ཆེན-པོ	(PH) Mahāratha [p.n.]
ཤིང-རྟའི-ལམ-སྲོལ	(PH) way of a charioteer
ཤིང-རྟའི-སྲོལ	(PH) way of a charioteer
ཤིང-རྟའི-སྲོལ-འབྱེད	(PH) opener of the way of a charioteer
ཤིང-སྲིན	(PH) woodworm
ཤིང-ཐོག-ཨ-མྲ	(PH) mango fruit
ཤློ-ཀ	(PH) stanza
ཤོག-གྱར	(PH) page fragment
ཤྲཱི-པཱ-དུ-ཀ	(PH) Śrīpāduka (enormous footprint of the Buddha in Śrī Lanka)
ཤུགས	(PH) implicit(ly)
ཤུགས-འབྱུང-རང-རིས-གཡས-སུ-འཁྱིལ-བའི-དུང	(PH) self-arisen clockwise spiraling conch shell
ཤུགས-དྲག	(PH) strong; great strength; intense
ཤུལ	(PH) ruins; remains
ཤུར-པ	(PH) juniper [incense]
ཤུར-ཤིང	(PH) juniper tree
སི	(PH) "si" [a type of incense]
སི-ལ	(PH) "sila" [a type of incense]
སིང-ག-ལ-པ	(PH) Singhalese [person]
སྐ-བ	(PH) astringent
སྐབས-གསུམ	 (PH) three times|(PH) three realms 
སྐད-ཅིག-བར	(PH) momentarily
སྐད-ཅིག-དང-པོ	(PH) first moment
སྐད-ཅིག-གཅིག-གིས	(PH) instantaneously
སྐད-ཅིག-གཉིས-པ	(PH) the second moment
སྐད-ཅིག-མ-གཅིག-པོ	(PH) first moment
སྐད-ཅིག-མ-གཅིག-པོ-དེ-ཉིད	(PH) the very first moment
སྐད-རིགས-ཆེན-པོ-བཞི	(PH) the four major languages (Sanskrit; Prakrit; Apabhraṃśa; Pisachi)
སྐལ	(PH) suitable; worthy
སྐལ-བཟང	(PH) good fortune; auspicious age
སྐལ-པ-བཟང-པོ	(PH) auspicious age
སྐལ-པ-རབ-ཏུ-གྱུར-པ	(PH) most fortunate
སྐལ-རྫོངས	(PH) dowry
སྐལ-ཚིགས	(PH) backbone
སྐར-མ	(PH) star
སྐར-མའི-ཚོགས	(PH) collection of stars; host of stars
སྐེ-ལྦ-བ	(PH) neck goiter
སྐོར-བཅུ-གཅིག	(PH) eleven cycles
སྐོར-དགུ	(PH) nine cycles
སྐྲ-ཤད	(PH) strand of hair; comb
སྐྲ-སྣུམ	(PH) hair oil
སྐུ	(PH) lifetime
སྐུ-བླུགས	(PH) metal image
སྐུ-བླུགས-མ	(PH) metal image
སྐུ-སྐྱེ	(PH) incarnation
སྐུ-ཚེ	(PH) life; life-span
སྐུལ-བྱེད-མ	(PH) Cundavajrī
སྐྱ-བོ	(PH) piece; morsel
སྐྱ-ནར-གྱི-བུ	(PH) Pātalīputra
སྐྱ-སེར-གཉིས	(PH) ordained and lay people
སྐྱབས-འགྲོ	(PH) going for refuge
སྐྱབས-འགྲོའི-སྡོམ-པ	(PH) refuge vows
སྐྱབས-སེང	(PH) Pāṇḍu [father of the five Pandavas]
སྐྱབས-སུ-འགྲོ-བ	(PH) going for refuge
སྐྱབས-སུ-འགྲོ-བའི-ཆོ-ག	(PH) ritual for taking refuge
སྐྱེ-འཕྲེང	(PH) garland of lives; sequence of lives; successive incarnations
སྐྱེ-བ-དགུ	(PH) nine-fold birth [realms]; [all those of the] nine-fold birth [realms]; (many or all) beings
སྐྱེ-བའི-ཕྲེང-བ	(PH) garland of lives; sequence of lives; successive incarnations
སྐྱེ-བོ-རྨོངས-པ	(PH) confused being
སྐྱེ-དགུ	(PH) nine-fold birth [realms]; [all those of the] nine-fold birth [realms]; (many or all) beings
སྐྱེ-དགུའི-བདག-པོ	(PH) Prajapati [n. of the fourth constellation]
སྐྱེ-མ	(PH) that which is produced
སྐྱེ-མཆེད	(PH) sense-sphere; source
སྐྱེ-མི-རུང-གི-ཆོས-ཅན	(PH) having the quality of not being suitable to be produced again
སྐྱེ-པོ-བདག-འཛིན-ཅན	(PH) Proponent of Permanent Existence
སྐྱེ-རྨོངས	(PH) confused being
སྐྱེ-ཤི-བར-དོ	(PH) birth; death; and the intermediate state
སྐྱེ-ཐེབས	(PH) section of generation
སྐྱེ-ཐེབས-གཉིས	(PH) two sections of generation
སྐྱེད-ཚལ	(PH) grove; garden
སྐྱེམ-ཙམ-རེ	(PH) just briefly
སྐྱེན-བུ	(PH) reason
སྐྱེས	(PH) present; gift
སྐྱེས-འཕྲེང	(PH) garland of lives; sequence of lives; successive incarnations
སྐྱེས-བུ	(PH) The Person
སྐྱེས-བུ-ཆུང-བ-ཁྱད-པར-ཅན	(PH) special being of small capacity
སྐྱེས-བུ-གསུམ-ཀ	(PH) beings of the three capacities
སྐྱེས-བུ-རྨོངས-པ	(PH) confused being
སྐྱེས-པ-ཉིད	(PH) men themselves
སྐྱེས-ཕྲན	(PH) boy
སྐྱིད-པ	(PH) happy; joyful
སྐྱོ-བ	(PH) disgust; disregard for
སྐྱོ-ངོགས	(PH) quarrel
སྐྱོན	(PH) fault; mistake
སྐྱོན-མི-བརྗོད-པ	(PH) non-fault-statement [(1) not pointing ou the fault; or (2) pointing out the non-fault]
སླ-ང	(PH) frying pan
སླད-བཞིན	(PH) later; future
སླད-བཞིན-དུ	(PH) later; in the future
སླད-ཀྱིས	(PH) subsequently; later
སླང-ང	(PH) large pot
སླར	(PH) (arch.) outside; back
སླར-ཡང	(PH) again; further; furthermore
སླས	(PH) attendent; retinue
སློབ-བཞིན-པ	(PH) one who strives
སློབ-དཔོན-དབང-བསྐུར	(PH) preceptor initiation
སློབ-དཔོན-ཤན-ཏི-པ	(PH) Acarya Śantipa
སློབ-དཔོན-ཞི-བ-འཚོ	(PH) the master; Śāntarakṣita
སློབ-ལམ	(PH) paths of learning
སློབ-ལྡན	(PH) intelligent; learned
སློད-བྱེད	(PH) pollution; polluting agent
སླུ-བ-མེད-པ	(PH) infallible
སླུ-མེད	(PH) infallible
སླུ-མེད-མཆོག-གསུམ	(PH) infallible Three Jewels
སྨག-འཐུག-པོ	(PH) thick darkness
སྨན	(PH) medicine
སྨན-རྟ	(PH) medium of medicinal consumption
སྨན-རྩེ	(PH) [Chinese] barbarians
སྨན-རྩི	(PH) medical elixir
སྨན-རྩིས-ཁང	(PH) Astro-Medical College
སྨེ-ཤ-ཅན	(PH) Followers of Durgā
སྨོན-ལམ	(PH) aspirational prayers; wishes; prayer-wishes; prayer
སྨོན-ལམ-ཆེན-པོ-བཅུ	(PH) ten great aspirational prayers [of a first ground bodhisattva]
སྨོན-ལམ-གྱི-སྟོབས-ཅན	(PH) having the power of wishing
སྨོན-ལམ-ཁྱད-པར-བློ-གྲོས	(PH) Praṇidhāna-vaiśeṣika-mati [pn. of a bodhisattva-mahāsattva]
སྨྲ-བ-མཆོག	(PH) the best of propounders
སྨྲ-བ-པོ	(PH) speaker
སྨྱིག-མ-མཁན	(PH) founder of a lineage
སྨྱིག-ཚལ	(PH) reed
སྨྱུག-པོ	(PH) brown
སྣ	(PH) various; varieties
སྣ-བའི-སྒོར-རྒྱུ-བའི-རླུང	(PH) wind that moves through the door of the ears
སྣ-ལ	(PH) at first
སྣ-ལྔ	(PH) five various; variegated five-[colored]
སྣ-མའི-མེ-ཏོག	(PH) jasmine flower
སྣ-ནམ-པ	(PH) Na-nam-pa [Dor-je-du-jom (sna nam rdo rje bdud 'joms); p.n. of one of Tri-song-de-tsen's ministers]
སྣ-རྡུམ	(PH) maimed nose; cut-off nose
སྣ-སྒྲ	(PH) nasal [sound]
སྣའི-བུ-ག	(PH) nostril
སྣའི-སྒོར-རྒྱུ-བའི-རླུང	(PH) wind that moves through the door of the nose
སྣམ-སྦྱར	(PH) [monk's] upper robe
སྣང	(PH) appearance
སྣང-བ	(PH) luminosity
སྣང-བ-མཆེད-པའི-ཏིང-ངེ-འཛིན	(PH) meditative stabilization of the increase of appearance
སྣང-ངོར-ཤེས-བྱ	(PH) objects of knowledge for the appearance factor
སྣང-ཕྱོགས-ཀྱི-ཆོས	(PH) phenomena of the appearing class
སྣང-ཤས	(PH) emphasis on the appearances
སྔ	(PH) half
སྔ-དྲོའི-དུས	(PH) morning
སྔ-གྲོ-གཅིག	(PH) one half day's journey
སྔ-ན	(PH) previously; formerly
སྔ-ཕྱི	(PH) previous and later; former and later
སྔ-ཕྱི-ཀུན	(PH) all former and later
སྔ-རོལ	(PH) earlier; prior; before
སྔགས-མཐུ-ཉིད	(PH) the power of mantra
སྔོ	(PH) blue
སྔོ-འཛིན-དབང-མངོན	(PH) sense direct perception apprehending blue
སྔོ-སེར	(PH) blue and yellow
སྔོ-སེར-དཀར-དམར	(PH) blue; yellow; white; and red
སྔོ-སེར-དམར-དཀར	(PH) blue; yellow; red; and white
སྔོ-སི	(PH) light blue
སྔོན-ཆད	(PH) in the past
སྔོན-གནས-རྗེས-དྲན-གྱི-མངོན-ཤེས	(PH) superknowledge of recollecting former lives
སྔོན-གནས-རྗེས-དྲན-གྱི-ཤེས-པ	(PH) knowledge of former lives
སྔོན-གྱི-གནས-རྗེས-སུ-དྲན-པ-ཤེས-པ	(PH) superknowledge of recollecting former lives
སྔོན-གྱི-གནས-རྗེས-སུ-དྲན-པའི-མངོན-ཤེས	(PH) superknowledge of recollects former lives
སྔོན-གྱི-སྲོལ	(PH) ancient tradition
སྔོན-ནས	(PH) previously; prior
སྣོད	(PH) container-organ
སྣོད-བཅུད	(PH) environment and [its] inhabitants
སྣུམ	(PH) oil
སྙམ	(PH) [closing quotation marker for a thought]; thinking
སྙན-འཇེབས	(PH) sweet-sounding and euphonous
སྙན-དངགས	(PH) poetry
སྙན-དངགས-ཀྱི-རིག-བྱེད	(PH) Samaveda
སྙན-སྒྲ	(PH) pleasant sound
སྙེད-ཅིག	(PH) just how much
སྙིགས-མ	(PH) degeneration; Degenerate [Era]
སྙིགས-མ-ལྔ	(PH) five degeneration
སྙིམ-པ-གང	(PH) a cupped hands' worth [of something]
སྙིང-བརྩེར-ལྡན	(PH) compassionate
སྙིང-གའི-རྩ-འདབ	(PH) channel-petals of the heart [cakra]
སྙིང-གའི-རྩ-འདབ-བརྒྱད	(PH) eight channel-petals of the heart [cakra]
སྙིང-གའི-རྩ-འདབ-བརྒྱད-ཀྱི-རྒྱུན	(PH) continuation of the eight channel-petals of the heart [cakra]
སྙིང-གི-ཟུངས	(PH) strength of heart
སྙིང-ཁ	(PH) heart
སྙིང-པོ	(PH) heart-essence; point
སྙིང-སྟོབས	 (PH) courageousness; fortitude; (lit.) power of heart|(PH) courageousness; fortitude; (lit.) power of heart 
སྙིང-སྟོབས-ཅན	(PH) lightness dominated
སྙིང-ཐོབས-ཅན	(PH) lightness
སྙིང-ཐོབས-ཅན-གྱི-ང-རྒྱལ	(PH) lightness dominated I-principle
སྙོམས-པར-འཇུག-པ-དྲུག-པ	(PH) the six heretical sages
སོ	(PH) point; tooth
སོ-བཙུགས	(PH) sentry
སོ-དྲང	(PH) fangs
སོ-སྐྱེའི-ལམ	(PH) paths of common beings
སོ-སོ	(PH) respective
སོ-སོ-ནས	(PH) respectively; mutually
སོ-སོ-ཡང-དག-རིག-བཞི	(PH) the four individual correct knowledges
སོ-སོ-ཡང-དག-རིག-པ	(PH) individual correct knowledge
སོ-སོར-འབྱེད-པ	(PH) differentiation
སོག	(PH) straw
སོག-བྱིལ	(PH) sok-jil ear-ring [long ear-ring that can only be worn by sons of aristocracy]
སོག-མ	(PH) straw
སོག-རུལ	(PH) rotten straw
སོགས	(PH) etc.; and so forth
སོར-བསམ	(PH) individual withdrawal and concentration
སོར-མོའི-ཕྲེང-བ-ཅན	(PH) Aṅgulimāla
སོར-མོའི-ཚིགས	(PH) finger digit; finger joint; knuckle
སོར-ཚིགས	(PH) finger digit; finger joint; knuckle
སྤ-གྲོ-མོན	(PH) Pa-tro [in the district of] Mön [near Bhutan]
སྤང-བླང-གི-འཇུག-ལྡོག	(PH) turning away from that which is to be abandoned and engaging in that which is to be adopted
སྤང-བྱ-གཅིག-ཆར-བ	(PH) simultaneous objects of abandonment
སྤང-བྱ-སྒོམ-སྤང-རྟོག-པ	(PH) the conceptions which are objects of abandonment to be abandoned by the path of meditation 
སྤང-བྱ-སྤོང-ཚུལ	(PH) the mode of abandoning the objects of abandonment
སྤང-བྱའི-གཙོ-བོ	(PH) main object of abandonment
སྤང-གཉེན-གྱི-འདོད-ཚུལ	(PH) mode of assertion of [objects of] abandonment and antidotes
སྤང-ཀོང-ཕྱག-བརྒྱ-པ	(PH) "One Hundred Homages for Mending Transgressions" (D 267)
སྤངས-བྱའི-གཙོ-བོ	(PH) main object of abandonment
སྤར-གྱི-བླ-མ	(PH) teacher's teachers
སྤར-ཁ-བརྒྱད	(PH) eight trigrams
སྤོ	(PH) vicinity; area; location
སྤོ-ཐོ	(PH) earthen mound; grassy knoll
སྤོང-ཚུལ	(PH) mode of abandonment
སྤོས	(PH) incense
སྤྲང-མོ	(PH) lowly (female) mendicant
སྤྲིན-བཞིན	(PH) nimbly; like a cloud
སྤྲིན-མེད	(PH) "Cloudless" [n. fourth concentration in the Form Realm]
སྤྲིན-ཕུང	(PH) mass of clouds
སྤྲིན-རུམ	(PH) dark cloud
སྤྲིས-མ	(PH) cream; congealed fat
སྤྲོ-བ	(PH) happiness
སྤྲུལ	(PH) snake
སྤྲུལ-པ	(PH) emanation
སྤུ-ཤད-རྩེ-མོ	(PH) tip of one hair
སྤུན	(PH) weaving thread (weft; abbr. of _spun thag_)
སྤུན-ཟླ	(PH) elders
སྤྱད-བྱ	(PH) objects of use
སྤྱན-ལྡན	(PH) [Dharma-] sight; endowed with the eye [of the Dharma]
སྤྱན-རས-གཟིགས-ཀྱི-དབང-པོ	(PH) Avalokiteśvara
སྤྱན-སྔ-རུ	(PH) in the presence (of)
སྤྱང-དུག-པ	(PH) wolfsbane
སྤྱེ	(PH) distinctive feature
སྤྱི	(PH) General [Principle]
སྤྱི-བརྟོལ	(PH) shameless
སྤྱི-བརྟོལ-ཅན	(PH) vanity; vain; shameless
སྤྱི-གཙོ-བོ	(PH) general principal [Sāmkhya]
སྤྱི-མཐུན	(PH) general welfare
སྤྱི-ཚོགས	 (PH) society|(PH) [Tibetan] General Assembly 
སྤྱིར-རང-ལས-ངེས-ཤིང-ཁྱད-པར-གཞན-ལས-ངེས-པ	(PH) [a valid cognition] that in general induces ascertainment from itself and in particular induces ascertainment from another
སྤྱོ-བྱ	(PH) victim; one who is abused
སྤྱོད-ལམ	(PH) path of activity; observances
སྤྱོད-ལམ-བཞི	(PH) four observances
སྤྱོད-ལམ-རྣམ-པ-བཞི	(PH) four types of observances
སྤྱོད-མཆོག	(PH) supreme deeds
སྲན	(PH) pea; bean
སྲང-མདའ	(PH) scale; balance
སྲེད-ལེན	(PH) attachment and grasping
སྲེད-པ-ལེན-པ	(PH) attachment and grasping
སྲིད	(PH) length
སྲིད-དང-ཞི-བ	(PH) mundane existence and pacification
སྲིད-པ	(PH) equivalence [one of the eleven pramāṇas attributed to Caraka]; length; extension; government
སྲིད-པ-དང-ཞི-བ	(PH) mundane existence and pacification
སྲིད-པ-ཐ-མའི-ཚེ	(PH) last lifetime in cyclic existence
སྲིད-པའི-ཟུག	(PH) pains of existence
སྲིད-རྩེའི-ས	(PH) level of the peak of cyclic existence
སྲིད-ཞི	(PH) mundane existence and pacification; [syn. for] samsara and nirvāṇa
སྲིན-གྱི-ཁ-ཆུ	(PH) silken threads; insect's cocoon
སྲིན-མོ	(PH) rakṣasī; siren; ogress
སྲོག	(PH) vitality; vital essence
སྲོག-འཛིན-གྱི-རླུང-མི-ཤིགས-པ	(PH) indestructible life-bearing wind
སྲོལ	(PH) system; way; custom
སྲུང-བ-པ	(PH) Āvantakas [one of the eighteen Vaibhāṣika Schools]
སྟག-རས	(PH) tiger skin
སྟག-རི	(PH) Tiger Mountain
སྟན-གཅིག	(PH) one session; single session
སྟེང-ཆ	(PH) upper part
སྟེང-དུ	(PH) in addition (to); in relation (to); in terms (of)
སྟེང-ཁང	(PH) upper floor
སྟེང-ཁར	(PH) on top (of)
སྟེང-ནས	(PH) on the basis
སྟེང-ཕྱོགས	(PH) zenith
སྟེང-སྒོ	(PH) upper gate; upper door
སྟི-གནས	(PH) dwelling; a place to stay
སྟོབས	(PH) power; force; strength
སྟོབས-ཆུང	(PH) weak; weakling
སྟོད	(PH) upper [part]; first [part]
སྟོད-ལུང-པ	(PH) Tölung (Valley) [a district near Lhasa]
སྟོན	 (PH) autumn|(PH) autumn 
སྟོན-གནམ	(PH) autumn sky
སྟོན-པ-པོ	(PH) teacher
སྟོན-ཟླ-འབྲིང-པོ	(PH) second month of the fall rainy season (aśvayuja / aśvina)
སྟོན-ཟླ-ར-བ	(PH) first month of the fall rainy season (bhādrapada / bhādra)
སྟོན-ཟླ-ཐ-ཆུང	(PH) third month of the fall rainy season (kārttika)
སྟོང	(PH) thousand
སྟོང-གསུམ-འབུམ-ཕྲག	(PH) one hundred thousand three-thousand [world systems]
སྟོང-གསུམ-འབུམ-ཕྲག-བཅུ	(PH) one million three-thousand [world systems] (lit. ten hundred thousand three-thousand [world systems])
སྟོང-གཞི	(PH) basis [upon which] emptiness [is predicated]
སྟོང-ཁུན	(PH) eastern emperor
སྟོང-རྩ-གཅིག	(PH) one thousand and one
སུག-ཐུང	(PH) Suk-tung ("short-legged") [a style of script]
སུམ-གཉིས	(PH) two of the three
སུམ-མདོ	(PH) three-fold intersection
སུན-འབྱིན-བྱེད-ཕྱོགས	(PH) refutative thesis
ཏཱ-ཤི་	(PH) [Chinese] monk
ཐ-དད-པའི-འདུས-བྱས	(PH) different compositional phenomena
ཐ-ན	(PH) even; even so much as
ཐ-ཤལ-བ	(PH) worst; mundane; inferior
ཐ-ཤལ-པ	(PH) mundane; inferior
ཐ-སྙད	 (PH) [verbal] designation; verbal convention; conventionalities; conventional [phenomena]|(PH) [verbal] designation; verbal convention; conventionalities; conventional [phenomena] 
ཐ-སྙད-འཇུག-ཚུལ	(PH) usages of the verbal designation
ཐ-སྙད-དཔྱོད-པའི-རིགས-པ	(PH) reasoning that analyses conventionalities
ཐ-སྙད-ཀྱི-གདགས-གཞི	(PH) basis of designation of verbal conventions
ཐ-སྙད-པ	(PH) conventionality
ཐ-སྙད-རིག-པའི-བཏགས-མིང	(PH) grammatical name; Sanskritic name as a grammarian [on the completion of the course of study of the three grammatical systems the successful student was given a grammatical name under which he wrote any works dealing with philological studies; literature; mathematics and astronomy; and medicine.]
ཐབ-བེ-ཐིབ-བེ	(PH) dizzy
ཐབས	(PH) group; community
ཐབས-ཉིད	(PH) methodology
ཐད	(PH) company
ཐག-མི-རིང	(PH) not far
ཐལ-འགྱུར-པ	(PH) Prāsaṅgika
ཐལ-བ	(PH) dust; ash
ཐམ-མ	(PH) last
ཐམས-ཅད-མཁྱེན	(PH) all-knowing; omniscient
ཐམས-ཅད-མཁྱེན-གཟིགས	(PH) all-knowing and all-seeing
ཐམས-ཅད-མཁྱེན-ཉིད་	(PH) all-knowledge; omniscience
ཐམས-ཅད-སྟོང-པ	 (PH) all-empty; emptiness of all [things]|(PH) all-empty; emptiness of all [things] 
ཐང	(PH) instant; moment; plain; field
ཐང-འགའ	(PH) few moments
ཐར-པའི-གོ-འཕང	(PH) the state of liberation
ཐེ-ཚོམ-པ	(PH) doubter; one who has a doubt
ཐེག-ཆེན-གྱི-ས-བཅུ	(PH) ten grounds of the Great Vehicle
ཐེག-ཆེན-རིགས-ངེས	(PH) [a person who is] definite in the Great Vehicle lineage
ཐེག-དམན-རིགས-ངེས	(PH) [a person who is] definite in the Lesser Vehicle lineage
ཐེག-དམན-ཡིད-བྱེད	(PH) mental engagement of someone on the Lesser Vehicle [path]
ཐེག-མཆོག-གོ	(PH) armor of the supreme vehicle
ཐེག-པ-རང-ལམ	(PH) the vehicle which is its own path
ཐེག-པ-རང-ལམ-གྱི-བྱ-བ	(PH) the activities of one's own path; [that is to say;] vehicle
ཐེག-པ-རང-ལམ-གྱི-མི-སློབ-ལམ	(PH) the path of no more learning of the vehicle which is own its path
ཐེར-མ	(PH) wool; serge-cloth
ཐིག	(PH) drop
ཐིག-ལྡེབ	(PH) long folio
ཐིག-ལེ-ཁྲོ-བོ-ཅན	(PH) spotted antelope
ཐིག-ཕྲེང	(PH) printed lines
ཐིག-སྡེབ	(PH) written line(s); line(s) written
ཐིག-ཚོན	(PH) colored drops
ཐོད	(PH) turban; crown; head-ornament
ཐོག	(PH) lightning
ཐོག-བབས-པ	(PH) thunderbolt; flash of lightening
ཐོག-མ-མེད-པའི-དུས-ནས	(PH) since beginningless time
ཐོག-མར-མེད	(PH) beginningless [time]
ཐོག-མེད-དུས-ནས	(PH) from beginningless time
ཐོག-མཐའ	(PH) beginning and end
ཐོག-མཐའ-བར	(PH) the beginning; middle; and end
ཐོག-ཐོག	(PH) all about
ཐོག-ཏུ	(PH) at the head of
ཐོགས-བཅས	(PH) obstruction
ཐོགས-མེད	(PH) unobstructed
ཐོན-མི	(PH) Thon-mi [Saṃbhota]
ཐོས-པའི-དོན-སྒྲ-ཇི-བཞིན-མ-ཡིན-པ	(PH) non-literal meaning of what is heard
ཐུ-ཆུངས	(PH) youngest brother
ཐུབ-བསྟན	(PH) teachings of the Subduer; teachings of [Śākya]muni
ཐུབ-པ	(PH) capacity
ཐུབ-པའི-ཐུགས	(PH) the exalted mind of the Subduer
ཐུག-གི-བར-དུ	(PH) until
ཐུག-ཐུག-ཏུ	(PH) reaching up to
ཐུགས-དམ	(PH) [object of] meditation practice
ཐུགས-ཁ	 (PH) in front (of); in the presence (of)|(PH) heart 
ཐུགས-ཁར	(PH) in front (of); in the presence (of)
ཐུན	(PH) dosage
ཐུན-གཞུག	(PH) the remainder of the session
ཐུན-ཁུང	(PH) demon box
ཐུན-མིན-མཆོག-དབང-གོང-མ-གསུམ	(PH) three higher uncommon supreme empowerments
ཐུན-མོང-མ-ཡིན-པ-ནང-གི-སྔོན-འགྲོ	(PH) the specific inner preliminaries
ཐུན-མོང-མིན-པའི-ཁྱད-ཆོས	(PH) uncommon distinguishing feature
ཐུང-ཤད	(PH) short line
ཏིང-འཛིན-མང-ལྡན	(PH) possessing many meditative stabilizations
ཏོན-མིན-པ	(PH) subitist; proponent of sudden enlightenment
ཙ-ར-ཀ	(PH) Caraka
ཙ-རི-ཀ	(PH) Caraka
ཙ-རི-ཀ-པ	(PH) Follower of Caraka
ཙམ	(PH) about; approximately
ཙམ-ཁུག	(PH) bag of tsampa
ཙན-དན-ཚལ-གྱི-དུར-ཁྲོད	(PH) Sandalwood Grove Charnel Ground (one of the eight traditional charnal grounds)
ཙནད	(PH) sandalwood
ཙནདན	(PH) sandalwood
ཙེན-མིན-པ	(PH) gradualist; proponent of gradual enlightenment
ཚ-བའི-གདོན	(PH) [beings in] hot hells
ཚབ-ཏུ	(PH) rather than
ཚད	(PH) measure; extent; certain amount
ཚད-མ-ཀུན-ལས-བསྟུས-པའི-འགྲེལ-བཤད་	(PH) [Jinendrabuddhi's] Explanation of [Dignāga's] Compendium on Valid Cognition
ཚད-མ-ཀུན-ལས-བཏུས-པ	(PH) [Dignāga's] Compendium of Valid Cognition
ཚད-མ-ཡིན-པ	(PH) being a valid cognition
ཚད-མེད-བཞི	(PH) Four Immeasurables
ཚད-མེད-པ-བཞི	(PH) Four Immeasurables
ཚད-མིན	(PH) non-valid [cognition]
ཚད-མིན-གྱི-ཞེན-རིག	(PH) non-valid [conceptual] determinitive knower
ཚད-སྐོམ	(PH) hot parching thirst
ཚལ	(PH) grove; forest; vegetables
ཚན	(PH) group
ཚན-བཅུ-གཉིས	(PH) twelve groups
ཚན-གྱི-ས	(PH) fully-qualified ground
ཚང	(PH) place; dwelling
ཚངས-བུག	(PH) Brahma (cranial) aperture
ཚངས-པའི-ལྷ	(PH) god of the Brahma abodes
ཚངས-པའི-མེ	(PH) Brahma-fire; Caṇḍalī-fire
ཚངས-པར-གྱུར-པ	(PH) being [like] Brahma
ཚངས-རིས	(PH) Brahma abodes
ཚངས-རིས-པ	(PH) one in the Brahma abodes
ཚངས-སྤྱོད	(PH) celibate practitioner
ཚར-བཅད-པའི-གནས	(PH) condition of defeat
ཚེ-འདས-པ	(PH) deceased; dead person
ཚེ-དང-ལྡན-པ-རབ-འབྱོར	(PH) venerable Subhūti
ཚེ-ལོ	(PH) life-span
ཚེ-རྟོག-པ	(PH) the thoughts concerning this life
ཚེ-སྤང-བཟའ	(PH) Lady from Tsepang [Queen to Tri-song-de-tsen]
ཚེ-སྤོང-གཟའ	(PH) Tshe-pong-za [wife of King Tri-song-de-tsen (khri srong lde btsan)]
ཚེམས	(PH) tooth
ཚེར-མ	(PH) thorn; briar
ཚེས-ཟླ	(PH) lunar month
ཚིག	(PH) word; bound morpheme
ཚིག-བླ-དགས	 (PH) synonym; epithet; appellation|(PH) synonym; epithet; appellation 
ཚིག-བླ-དྭགས	(PH) synonym; epithet; appellation
ཚིག-དོན-དྲུག	(PH) six categories [of existents]
ཚིག-དོན-གསོལ-འདེབས	(PH) seven line prayer
ཚིག-གཡུང	(PH) inauspicious words
ཚིག-གི-དོན-དྲུག	(PH) six categories [of existents]
ཚིག-རེ-ནས	(PH) word-by-word
ཚིག-ཚིག-པ	(PH) burning
ཚིག-ཟུར	(PH) indirect expression
ཚིགས	 (PH) lineage; connected | (PH) verse line; joint; combination|(PH) chapter 
ཚིགས-འབྲུ-སྒྲ-ཇི-བཞིན-གྱི-དོན	(PH) literal meaning of letters
ཚོད	(PH) amount; quantity
ཚོད-ཙམ	(PH) about as much (as)
ཚོགས	(PH) accumulation; collection; composite
ཚོགས-འཁོར	(PH) gaṇacakra feast
ཚོགས-བྲན	(PH) servant of the people
ཚོགས-ཀྱི-འཁོར-ལོ	(PH) gaṇacakra feast
ཚོགས-ཀྱི-འཁོར-ལོའི-ཆོ-ག	(PH) gaṇacakra feast ritual
ཚོགས-སྦྱོར-གཉིས	(PH) [paths of] accumulation and preparation
ཚོགས-ཙམ	(PH) mere collection
ཚོན	(PH) hue; dye; coloring; finger-joint-length
ཚོན-རྩི	(PH) colored paint
ཚོང-པའི-བུ	(PH) merchant's son
ཚོར-བ-དྲན-པ-ཉེ-བར-གཞག-པ	(PH) application of mindfulness based on feelings
ཚོར-བ-དྲན-པ-ཉེར-གཞག	(PH) application of mindfulness based on feelings
ཚུ-རོལ-མཐོང-བ	(PH) one who sees nearby [i.e. an ordinary being]
ཚུལ-བཞིན	(PH) properly; proper manner; right way
ཚུལ-བཞིན-དུ	(PH) properly; correctly
ཚུལ-དངོས	(PH) direct method; actual method
ཚུལ-གསུམ-པའི-རྟགས	(PH) three-fold proof
ཚུལ-རྣམ	(PH) mode
ཚུལ-རྣམ-གཉིས	(PH) two modes
ཚུལ-རྟགས	(PH) method of diagnosis
ཚུན-ཆད	(PH) down to and including
ཚུར	(PH) nearby
ཚུར-འབྲེལ-པ	(PH) reciprocal love
ཚུར-མཐོང	(PH) one who sees nearby [i.e. an ordinary being]
ཙོག-བུ	(PH) upright
ཙོག-ཙོག-པུ	(PH) cowering; squatting; crouching down
ཨུཏཔ-ལ	(PH) Utpala flower
ཨུཏཔ-ལ-ཅན	(PH) Utpalaka
ཨུཏཔལ	(PH) Utpala flower
ཝ-ར-ན-སི	(PH) Vārāṇasī
ཝ-ར-ནཱ-སི	(PH) Vārāṇasī
ཝཱ-ར-ཎཱ-སི	(PH) Vārāṇasī
ཝ-སི	(PH) [a kind of apple]
ཡ-མཚན	(PH) strange; miraculous
ཡ-མཚན-ཅན	(PH) hypocritical philosopher; philosophers with strange views
ཡ-མཚན-པ	(PH) miraculous events
ཡ-ང-པ	(PH) frightening
ཡ-ང-པ-ཅན	(PH) dangerous
ཡ-རྩེ	(PH) Yatse [a reagion in Ngari]
ཡ-སྟག	(PH) sacrificial scapegoat (Bon-po tech. term)
ཡ-སྟག-ནང-པ	(PH) entrails of a sacrificial scapegoat (Bon-po tech. term)
ཡབ-ཡུམ	(PH) diety and consort; buddha(s) and consort(s); parents
ཡག-ཤོས	(PH) best
ཡམས	(PH) plague; epidemic
ཡམས-ནད	(PH) plague; epidemic
ཡན	(PH) below; down
ཡན-ཆད	(PH) area and areas to the west
ཡན-ལག-བདུན-པ	(PH) Seven Limb Prayer
ཡན-ལག-གི-དམ-ཚིག	(PH) branch commitments
ཡང	(PH) light [as in not heavy]
ཡང-དག-བརྗོད-པ	(PH) correctly express
ཡང-དག-ཀུན-རྫོབ	(PH) real conventional [truth]
ཡང-དག-ཀུན-རྫོབ-ཀྱི-བདེན-པ	(PH) real conventional truth
ཡང-དག-ལམ	(PH) correct path
ཡང-དག-མཚན-ཉིད	(PH) pure character
ཡང-དག-པའི-ཀུན-རྫོབ	(PH) real conventional [truth]
ཡང-དག-པའི-ཀུན-རྫོབ-བདེན-པ	(PH) real conventional truth
ཡང-དག-པའི-ལམ-གྱི-ཆོས	(PH) attributes of the pure path
ཡང-དག-པའི-རིགས-ལམ	(PH) path of correct reasoning
ཡང-དག-པའི-སྨོན-ལམ	(PH) proper aspirational-prayer
ཡང-དག-པར-བརྗོད-པ	(PH) correctly express
ཡང-དག-པར-རྫོགས-པའི-སངས-རྒྱས-སེང-གེ-རྩལ	(PH) the completely perfect Buddha Siṃha-vikrama
ཡང-དག-སྨོན-པ	(PH) pure aspiration
ཡང-དང-ཡང-དུ	(PH) again and again
ཡང-ལོག	(PH) real and unreal; correct and mistaken
ཡང-ལོག-ཀུན-རྫོབ	(PH) real and unreal conventional [truths]
ཡང-རྩེ	(PH) peak; pinnacle
ཡང-སྔོན	(PH) even before
ཡང-སྲིད-པའི-ཉོན-མོངས-པ	(PH) the afflictions that give rise to another existence
ཡར	(PH) upper; upward
ཡར-གྱི-མཚམས-མེད	(PH) direct transition upward
ཡར-གྱི-ངོ	(PH) waxing moon
ཡར-མར	(PH) upward and downward; upper and lower
ཡར-སྣ	(PH) upper opening; upper end; latter half
ཡར-ཚེ	(PH) time of increase; time of waxing
ཡས-ཀྱི-མཆེ-བ	(PH) upper fangs
ཡས-རླུང	(PH) upper wind
ཡེ-ཤེས-བརྩོན-འགྲུས-རྩོམ-པ	(PH) initiation of effort [in dependence upon] exalted wisdom
ཡེ-ཤེས-སེམས-དཔའ	(PH) wisdom being (jñānasattva)
ཡེ-ཤེས-སྤྱན-ལྡན	(PH) endowed with the eye of the wisdom
ཡེར-པ	(PH) [Dra (brag)] Yerpa (cave retreat east of Lhasa)
ཡི-དམ-ཡབ-ཡུམ	(PH) tutelary deity with consort
ཡི-དམ-ཞི-ཁྲོ	(PH) peaceful and wrathful tutelary deities
ཡི-དམ-ཞི-ཁྲོའི-ལྷ-ཚོགས	(PH) collection of peaceful and wrathful tutelary deities
ཡི-གེ	(PH) phoneme
ཡི-གེ-གསར-པ	(PH) recent writings; new texts
ཡིའུ-རུའོ	(PH) You Ruo [direct disciple of Confucius]
ཡིའུ-ཙི	(PH) You Ruo [direct disciple of Confucius]
ཡིད-བྱེད-བཞིའི-གནས-སྐབས-ཅན	(PH) period of the four mental engagements
ཡིད-ཅན	(PH) sentient beings
ཡིད-ཆེས-ཀྱི-རྟགས-ཡང-དག	(PH) correct sign of belief
ཡིད-ཆེས-རྗེས-དཔག	(PH) inference through correct belief
ཡིད-གཉིས-ཅན	(PH) having doubt; being of two minds (on a subject)
ཡིད-ཀྱི-འདུས-ཏེ-རེག-པ	(PH) mental-contact
ཡིད-ཀྱི-མཚོ	(PH) Lake Mānasasarovara
ཡིད-ཀྱི-རོལ-པ	(PH) all-encompassing mind
ཡིད-ཀྱི-ཤིང-རྟ-ལ-དགའ-བ	(PH) Manorathanandin
ཡིད-ལ-བསམ-པ	(PH) aspiration; hope
ཡིད-ངོ	(PH) [appearance] to the mind; for such a mind
ཡིད-རབ-དང	(PH) sincere mind
ཡིད-ཤེས-འཁོར-གྱི-སེམས-བྱུང	(PH) mental factors accompanying a mental consciousness
ཡིད-ཤེས-རྒྱ-ཡན-པ	(PH) a dispersed mental consciousness
ཡིད-སྲུབས	(PH) confused-minded
ཡིག	(PH) syllable
ཡིག-གེ	(PH) syllable
ཡིག-གེ-དྲུག-པ	(PH) Six-syllable [mantra]
ཡིག-གེ-པར-བསྟེན	(PH) secretary; clerk
ཡིག-ཚགས	(PH) archival documents; official archival records
ཡོད-ངེས-ཅན	(PH) definitely existent phenomena
ཡོད-རྫས	(PH) existent substance
ཡོད-ཚུལ	(PH) way of existing; way in which [something] exists
ཡོལ	 (PH) transit|(PH) dawn 
ཡོན-ཏན-གྱི-གྲངས-འཕེལ-པའི-ཁྱད-པར	(PH) the feature of an increase in the number of qualities
ཡོན-ཏན-ཁྱད-པར-ཅན	(PH) having special qualities
ཡོན-ཏན-ལྷག-པའི-ཁྱད-པར	(PH) the features of surpassing qualities
ཡོན-ཏན-མཁན	(PH) those skilled in good qualities
ཡོན-ཏན-ཐོབ-ཚུལ	(PH) the mode of attaining qualities
ཡོངས	(PH) whole; entirety; all
ཡོངས-འཛིན-ཆེ-བ	(PH) senior tutor
ཡོངས-འཛིན-ཆུང-བ	(PH) junior tutor
ཡོངས-རྫོགས-བྱིན-རླབས	(PH) perfect blessing
ཡོངས-སུ-ཟླུམ-པོ	(PH) completely round; perfectly round
ཡོར-སྟོད	(PH) Yerpa county
ཡོས	(PH) grain; barley
ཡུ-གུར	(PH) Uyghur
ཡུད-ཀྱིས	(PH) instantaneously
ཡུད-པ-ཅན	(PH) Daṇḍin
ཡུལ-འབངས	(PH) peasant; serf
ཡུལ-བདེན-པ-བཞི	(PH) its object -- the four noble truths
ཡུལ-ཅན	(PH) object possessor; subject; subjective [consciousness]
ཡུལ-ཅན-ཐ-སྙད	(PH) conventional designations
ཡུལ-གྱི-འཛིན-སྟངས	(PH) mode of apprehension of objects
ཡུལ-ལྷ	(PH) local deity
ཡུལ-ཕྱོགས-ཀུན	(PH) all regions
ཡུལ-རྟོགས-ཚུལ	(PH) the mode of realizing objects
ཡུམ-བུ-ལྷ-ཁང	(PH) Yum-bu-lha-khang [Imperial palace of King Lha-tho-tho-ri-gnyan-btsan]
ཡུམ-བུ-ལྷ-མཁར	(PH) Yum-bu-lha-khang [Imperial palace of King Lha-tho-tho-ri-gnyan-btsan]
ཡུམ-གྱི-ལྷུམས	(PH) the mother's womb
ཡུན	(PH) duration; period; enduring
ཡུན-མི-རིང	(PH) not far off
ཡུན-རིང-སུ	(PH) for a long time
ཡུན-རིངས	(PH) long time
ཡུན-ཐུང-བ	(PH) short period of time
ཡུན-ཚད	(PH) length of time; period of time
ཡུངས-འབྲུ-ཙམ-པོ	(PH) about the size of a mustard seed
ཡུངས-མར	(PH) sesame oil
ཟ-འོག-ཕུག	(PH) Zaog ("Brocade") Cave [n. of Milarepa's cave]
ཟ-པོ	(PH) enjoyer; gluttony
ཟ-སྒོ	(PH) share of allowance
ཟབ	(PH) deep; profound
ཟབ-མོ-ཉིད	(PH) utterly profound
ཟད-དྲག-པ	(PH) extremely weakened; thoroughly exhausted
ཟས-གཙང-སྲས-པོ	(PH) son of Śuddhodana
ཟེ-བ	(PH) [lion's] mane; flowing mane
ཟེད-པ	(PH) upright; right-side-up
ཞ-བོ-མིག-ཅན	(PH) a cripple with good eyesight
ཞབས-ལྷམ	(PH) "shoes for the alms bowl"
ཞབས-ཕྱི	(PH) servant; service
ཞབས-རྡུལ	(PH) dust of the feet
ཞབས-སེན	(PH) toe nail
ཞབས-ཏོག	(PH) respectful practice; respectful service; respectful treatment
ཞབས-ཟུང	(PH) pair of feet
ཞག-རེ	(PH) each day
ཞལ-བ	(PH) plaster; plastered wall
ཞལ-ཅེ-བ	(PH) magistrate
ཞལ-ཆེ-བ	(PH) magistrate
ཞལ-གཅིག-ཕྱག-བཞི	(PH) one face and four arms
ཞལ-གྲངས	(PH) census; head-count
ཞལ-ལྟག-པ	(PH) head; neck
ཞལ-ངོ	(PH) monastic proctor
ཞལ-སྔ	 (PH) oral instructions; command|(PH) exalted presence 
ཞང-བློན	(PH) minor minister
ཞར	(PH) ancillary [topic]; secondary
ཞར-བ	(PH) ancillary [topic]; secondary [as opposed to primary, dngos]
ཞེས-འབྱུང-བ	(PH) [quotation marker]
ཞེས-གྲགས	(PH) renown through tradition
ཞི-བ-བགྲོད-པ-གཅིག-པུ-པའི-ཉན-ཐོས	(PH) Hearers who progresses solely to peace
ཞི-ལྷག-གཟུང-འབྲེལ	(PH) union of calm abiding and special insight
ཞི-ལྷག-ཟུང-འབྲེལ	(PH) union of calm abiding and special insight
ཞི-ལྷག-ཟུང-དུ-འབྲེལ	(PH) a union of calm abiding and special insight
ཞི-ལྷག-ཟུང-དུ-འབྲེལ-བ	(PH) a union of calm abiding and special insight
ཞི-ལྷག-ཟུང-དུ-འབྲེལ-བའི-ཏིང-ངེ-འཛིན	(PH) a meditative stabilization that is a union of calm abiding and special insight
ཞིབ-འཚོ	(PH) Śāntarakṣita
ཞིབ-ཙམ	(PH) (in) some detail
ཞིག	(PH) one; single
ཞིག-པ	(PH) dissintegration
ཞིང	(PH) field
ཞོ-ཀྲོག	(PH) solid yogurt
ཞུ-དག	(PH) editing
ཞུ-རག-གི-བསམ-པ	(PH) intention of asking
ཞུམ-བུ	(PH) cat
ཞུམ-པ	(PH) timid
ཞུམ-པ-ཆེ	(PH) very timid
ཞུན-མ	(PH) melted
ཞུས-དག-པ	(PH) editor
ཞུས-ཚིག	(PH) question
ཟིམ-ཤིང	(PH) Jianzhang [palace; in Chang'an]
ཟླ-འོད-གཞོན-ནུ	(PH) Candraprabhakumara
ཟླ-བ-ཚེས-པ	(PH) lunar digit (candrakalā)
ཟླ-བ-ཡར-གྱི-ངོ	(PH) digit of the waxing moon
ཟླ-བ-ཡར-ངོ	(PH) digit of the waxing moon
ཟླ-བའི-གཟུགས-བརྙན	(PH) reflection of the moon
ཟླ-བའི-ལང-ཚོ	 (PH) fullness of youth; mature adolescent|(PH) crescent moon 
ཟླ-གྲགས	(PH) Candrakīrti
ཟླ-གཞོན	(PH) full moon
ཟླ-མཚན-གྱི-ཁྲག	(PH) menstrual blood
ཟླ-མཚན-གྱི-ཁྲག-དང-ལྡན	(PH) menstruating
ཟླ-མཚན-གྱི-ཁྲག-དང-ལྡན-པ	(PH) menstruating
ཟླ-མཚན-སངས	(PH) post-menopausal
ཟླ-རྟགས	(PH) crescent mark
ཟློས-གར	(PH) show; vain display
ཟློས-གར-བ	(PH) performer
ཟློས-གར-ཅན	(PH) assuming the form (of); putting on a show (of); having a disguise (of)
ཟུག-རྔུ	(PH) pangs; pain
ཟུག-རྔུས-ཟུག-པ	(PH) pain and pangs
ཟུང-འཇུག-གི-གོ-འཕང	(PH) stage of union
ཟུང-འཇུག-ཡེ-ཤེས	(PH) exlated wisdom [of the state of] union
ཟུང-ཐལ-མོ	(PH) palms of a pair [of hands]
ཟུར-མཁར	(PH) Zur-khar [a district in U (dbus - "Central Tibet")]
