འབྲས-བུ	Divisions: (1) fruitional effect; (2) dominant/empowering effect; (3) causally concordant effect; (4) personally made effect; (5) separative effect
འབྲེལ-པ	Divisions: (1) relation/related in the sense of being one entity (tadātmya-saṃbandha); (2) relation/related in the sense of arising from that (tadutpatti-saṃbandha)
འབྱུང-བར-གྱུར-པའི-རེག-བྱ	Divisions: (1) earth (pṛthivī); (2) water (āp); (3) fire (tejas); (4) wind (vāyu)
འགལ-བ	Div.: (1) contradictory in the sense of mutual abandonment; (2) contradictory in the sense of not abiding together
བཅད-ཤེས	Divisions: (1) directly perceiving subsequent cognizer; (2) conceptual subsequent cognizer
བདག-འཛིན	Divisions: (1) artificial conception of self; (2) innate conception of self
བདག-རྐྱེན	Div.: (1) uncommon empowering condition; (2) common empowering condition
བདེན-འཛིན	Divisions: (1) artificial conception of true existence; (2) innate conception of true existence
བདེན-པ	Divisions: (1) conventional truth; (2) ultimate truth
བེམ-པོ	Divisions: (1) external matter (bahirdhā-kanthā); (2) internal matter (ādhyātmika-kanthā)
བློ-རིག	Divisions: (1) direct perceiver (pratyakṣa); (2) inferential cognizer (anumāṇa); (3) subsequent cognizer (paricchinna-jñāna); (4) correctly assuming consciousness (manaḥ parikṣā); (5) awareness to which the object appears but is not ascertained (aniyata-p
བོད-སྐད	Divisions: (1) colloquial language; (2) religious language
བསམ-གཏན	Divisions: (1) first concentration; (2) second concentration; (3) third concentration; (4) fourth concentration
བསམ-གཏན-ས	Div.: (1) the [seven] preparations for the first concentration, the "not unable"; (2) the mere actual basis of the first concentration; (3) the special actual basis of the first concentration; (4) the second concentration; (5) the third concentration; (6)
བཏགས-ཡོད	Divisions: (1) imputed existents that are imputed in dependence upon another, their basis of imputation; (2) imputed existents whose apprehension must depend upon apprehending another phenomenon; (3) imputed existents that are merely imputed by thought
བྱ-རྒྱུད-རིགས	Divisions: (1) Tathāgata Lineage; (2) Lotus Lineage; (3) Vajra Lineage
བྱང-ཆུབ-ཀྱི-ཡན-ལག	Divisions: (1) mindfulness (smṛti); (2) discrimination of phenomena (dharma-vicaya); (3) effort (vīrya); (4) joy (prīti); (5) equanimity (upekṣā); (6) meditative stabilization (samādhi); (7) pliancy (praśrabdhi)
བྱང-སེམས-འཕགས-པའི-ས	Divisions: (1) the first ground, the Very Joyful; (2) the second ground, the Stainless; (3) the third ground, the Radiant; (4) the fourth ground, the Effulgent; (5) the fifth ground, the Difficult to Tame; (6) the sixth ground, the Manifest; (7) the seven
བྱང-སེམས-སོ-སྐྱེའི-ལམ	Divisions: (1) Bodhisattva path of accumulation; (2) Bodhisattva path of preparation
བྱེད-རྒྱུ	Divisions: (1) capable creative cause; (2) incapable creative cause
ཆོ-འཕྲུལ	Divisions: (1) miracles of magical emanation; (2) miracles of speaking everywhere; (3) miracles following teaching
ཆོས-ཀྱི-བདག-མེད	Divisions: (1) coarse selflessness of phenomena; (2) subtle selflessness of phenomena
དབང-མངོན	Divisions: (1) sense direct perception apprehending a form; (2) sense direct perception apprehending a sound; (3) sense direct perception apprehending smell; (4) sense direct perception apprehending taste; (5) sense direct perception apprehending a tangib
དབང-པོ	Divisions: the five [sense] powers which are internal form: (1) eye sense power; (2) ear sense power; (3) nose sense power; (4) tongue sense power; (5) body sense power        · the five powers which are harmonies with enlightenment: (1) faith; (2) effort;
དབང-པོ-དུརག	Div.: eye sense power, ear sense power, nose sense power, tongue sense power, body sense power, mental sense power
དབང-ཤེས	Divisions: (1) eye consciousness; (2) ear consciousness; (3) nose consciousness; (4) tongue consciousness; (5) bodily consciousness
དགག-པ	Div.: (1) affirming negative; (2) non-affirming negative
དགེ-བ	Div.: (1) faith (śraddhā); (2) shame (hrī); (3) embarrassment (apatrāpya); (4) non-attachment (alobha); (5) non-hatred (adveṣa); (6) non-ignorance (amoha); (7) effort (vīrya); (8) pliancy (prasrabdhi); (9) conscientiousness (apramāda); (10) equanimity (up
དགེ-རྩ	Div.: (1) non-attachment (alobha); (2) non-desire (arāga); (3) non-hatred (adveṣa); non-ignorance (amoha)
དམན-པའི-ས-པ	Divisions: (1) ground of seeing the wholesome; (2) ground of lineage; (3) ground of the eighth; (4) ground of seeing; (5) ground of dimishment; (6) ground free from desire; (7) ground of realizing completion; (8) ground of the Solitary Realizer  {T}
དམྱལ-བ	Divisions: (1) [eight] hot hells (dāha-naraka); (2) [eight] cold hells (śīta-naraka); (3) the hells of preliminary or lighter punishment which are situated in the neighborhood of the greater hells (pratya 'kanaraka); (4) hell of temporary punishment which
དངོས-པོ	Div.: (1) matter; (2) consciousness; (3) non-associated compositional factor
དངོས-པོའི-འབྲས-བུ	Div.: (1) thing's direct effect; (2) thing's indirect effect; (or) (1) thing's substantial effect; (2) thing's cooperative effect
དངོས-པོའི-ལྡོག-པ-དང-ཡིན-ཁྱབ-མཉམ	Equivalents: (1) one with thing; (2) thing that is one with thing; (3) definiendum of that which is able to perform a function; (4) the triply qualified imputed existent of that which is able to perform a function
དངོས-པོའི-རྒྱུ	Div.: (1) thing's indirect cause; (2) thing's direct cause; (or) (1) thing's substantial cause; (2) thing's cooperating condition
དོན-བྱེད-ནུས-པའི-ལྡོག-པ-དང-ཡིན-ཁྱབ-མཉམ	(1) one with able to perform a function; (2) [something that is] able to perform a function that is one with able to perform a function; (3) definition of functioning thing; (4) triply qualified actual existent that is a functioning thing
དོན-དམ	Divisions: (1) objective ultimate [i.e. suchness]; (2) attainment ultimate [i.e. nirvāṇa]; (3) practice ultimate [i.e. exalted wisdom of meditative equipoise]
དོན-དམ-པ	Divisions: (1) objective ultimate [i.e. suchness]; (2) attainment ultimate [i.e. nirvāṇa]; (3) practice ultimate [i.e. exalted wisdom of meditative equipoise]
དོན-གྱི-གཞན-སེལ	Divisions: (1) other-eliminator which is a factual specifically characterized phenomenon that is a factual specifically characterized phenomenon; (2) other-eliminator that is an awareness that is a factual specifically characterized phenomenon; (3) non-af
དོན-རང-མཚན-གྱི-གཞན-སེལ	Divisions: (1) other-eliminator which is a factual specifically characterized phenomenon that is a factual specifically characterized phenomenon; (2) other-eliminator that is an awareness that is a factual specifically characterized phenomenon; (3) non-af
དྲན-པ-ཉེ-བར-བཞག-པ	Divisions: (1) mindful establishment of body; (2) mindful establishment of feelings; (3) mindful establishment of thoughts; (4)  mindful establishment of phenomena
དྲན-པར-ཉེར-བར-བཞག-པ	Divisions: (1) mindful establishment of body; (2) mindful establishment of feelings; (3) mindful establishment of thoughts; (4)  mindful establishment of phenomena
དུད-འགྲོ	Divisions: (1) abiding in lethargy (?); (2) (?)
གང-ཟག	Div.: the two—ordinary beings (pṛthagjana) and Superiors (ārya)
གང-ཟག-གི-བདག-མེད	Div.: (1) coarse selflessness of persons; (2) subtle selflessness of persons
གཅིག	Divisions: (1) same self isolate; (2) same entity; (3) same type
གཅིག-པ	Divisions: (1) same self isolate; (2) same entity; (3) same type
གནས-ལུགས-ནད-གཞི	Div.: 1) the trunk of the healthy body abiding in a normal, balanced state, 2) the trunk of the unhealthy body, or diseased body, abiding in an unbalanced state
གནས-ལུགས-རྩ-བ	Div.: 1) [the trunk of the healthy body abiding in a normal] balanced state, 2) [the trunk of the unhealthy body, or diseased body, abiding in an] unbalanced state
གཏན-ཚིགས	Divisions: (1) property of the position (paksadharmata); (2) positive concomitance (anvaya); (3) negative concomitance (vyatireka) {GD:275}
གཞན-འགྱུར	Divisions: (1) sleep (middha); (2) contrition (kaukṛtya); (3) investigation (vitarka); (4) analysis (vicāra)
གཞན-ལས-ངེས-ཀྱི-ཚད-མ	Divisions: (1) prime cognizer for which ascertainment is induced by another with respect to the appearance; (2) prime cognizer for which ascertainment is induced by another with respect to the truth
གཞན-སེལ	Divisions: (1) affirming negative other-eliminator; (2) non-affirming negative other-eliminator
གཞི-གྲུབ	Div.: (1) permanent phenomena; (2) functioning things; or: (1) one; (2) different; or: (1) object of knowledge whose occurrence is possible; (2) object of knowledge whose occurrence is impossible; or: (1) negative phenomenon; (2) positive phenomenon; or:
གཞི-ཤེས-སྦྱོར-བའི-ངོ-བོ-ཉིད-བཞི	essential of isolation from the afflictions (nyon mongs las dben pa’i ngo bo nyid), essential of the nonexistence of assumptions of bad physical states that are signs of afflictions (nyon mongs kyi rtags lus kyi gnas ngan len med pa’i ngo bo nyid), essential of the nonexistence of improper [mental application], the [causal] mark of afflictions (nyon mongs kyi mtshan ma tshul bzhin min pa med pa’i ngo bo nyid), and essential of isolation from conceptions of [truly existent] adopting and discarding (blang dor gyi rnam rtog gis dben pa’i ngo bo nyid)
གཟུགས	Division: (1) internal form; (2) external form
གཟུགས-ཀྱི-སྐྱེ-མཆེད	Division: (1) shape; (2) color
གཟུགས-མེད-བསམ-གཏན	Division: (1) limitless space; (2) limitless consciousness; (3) absolute nothingness; (4) peak of cyclic existence
གཟུགས-མེད-པའི-སྙོམས-འཇུག	Division: (1) limitless space; (2) limitless consciousness; (3) absolute nothingness; (4) peak of cyclic existence
ཁམས	Div.: (1) desire realm; (2) form realm; (3) formless realm · Div.: the eighteen consisting of the six objects, the six sense powers, and the six consciousnesses
ཁམས-དུ-མ	Div.: (1) earth; (2) water; (3) fire; (4) wind; (5) space; (6) consciousness
ཁམས-སྣ-ཚོགས-པ	Div.: the eighteen consisting of the six objects, the six senses, and the six consciousnesses
ཁམས-ཐ-དད-པ	Div.: the eighteen consisting of the six objects, the six sense powers, and the six consciousnesses
ཁྱབ-པ	Div.: (1) forward pervasion; (2) reverse pervasion
ཁྱབ-པ-ཕྱིན-ཅི-ལོག	Div.: (1) perverse forward entailment/pervasion; (2) perverse reverse entailment/pervasion; (3) perverse downward entailment/pervasion; (4) perverse negative entailment/pervasion
ཁྱབ-པ-རྣལ-མ	Div.: (1) normative forward entailment/pervasion; (2) normative reverse entailment/pervasion; (3) normative downward entailment/pervasion; (4) normative negative entailment/pervasion
ཀུན-འགྲོ-ལྔ	Div.: feeling (vedanā), discrimination (samjñā), intention / attention (cetanā), mental engagement (manasikāra), contact (sparśa).
ཀུན-བརྟགས	Div.: (1) imputational natures of which the character is thoroughly nil; (2) enumerated imputational natures
ཀུན-རྫོབ	Divisions: (1) imputational conventionalities; (2) mental conventionalities; (3) expressional conventionalities. Also, (1) real/correct conventionalities; (2) unreal/incorrect conventionalities
ཀུན-རྫོབ-བྱང-ཆུབ-ཀྱི-སེམས	1 aspirational mind of enlightenment; 2 practical mind of enlightenment
ལམ	Divisions: (1) path of accumulation; (2) path of preparation; (3) path of seeing; (4) path of meditation; (5) path of no more learning
ལམ-ཤེས-སྦྱོར-བའི-ངོ-བོ-ཉིད-ལྔ	training in the difficult to achieve (sgrub dka' ba'i sbyor ba), training in definiteness of full purification one-pointedly (gcig tu 'tshang rgya bar nges pa'i sbyor ba), training in achieving the three great intents [great mind, great abandonment and great realization] (ched du bya ba chen po gsum sgrub pa'i sbyor ba), training in not observing the three spheres of meditation as ultimately existent (sgom pa'i 'khor gsum don dam par mi dmigs pa'i sbyor ba), training in stopping the conception of truly existent things (bden pa'i dngos por zhen pa bkag pa'i sbyor ba)
ལྡན-མིན-འདུ-བྱེད	Divisions: (1) non-associated compositional factor that arises as a person; (2) non-associated compositional factor that does not arise as a person
ལྡེམ-དགོངས-བཞི	Div.: 1) Intending entry (avatāra · nābhisaṃdhi), 2) Intending the characters (lakṣaṇābhisaṃdhi) 3) Intending an antidote (pratipakṣābhisaṃdhi), 4) Intending translation (pariṇāmābhisaṃdhi).
ལྡོག	Divisions: (1) meaning isolate (artha-vyatireka); (2) generality isolate (sāmānya-vyatireka); (3) illustration isolate (lakṣya-vyatireka); (4) self-isolate (sva-vyatireka)
ལྡོག-ཆོས	Div.: the first three isolate phenomena: (1) isolate phenomenon that is itself; (2) isolate phenomenon that is not itself; (3) isolate phenomenon that is a mere third possibility;  · the four latter concordant isolate phenomena: (4) concordance with substan
ལྡོག-པ	Divisions: (1) generality isolate; (2) self isolate; (3) meaning isolate; (4) illustration isolate
ལྡོག-པ-ངོས-འཛིན	Divisions: (1) generality isolate; (2) self isolate; (3) meaning isolate; (4) illustration isolate
ལེ-ལོ	Div.: 1) laziness of inadequacy, 2) laziness which is an attachment to bad activities, 3) laziness of neutral activities
ལྐོག-གྱུར	Div.: (1) slightly hidden phenomenon [e.g., impermanence}; (2) very hidden phenomenon [e.g., the particular effects of karmas]
ལོག-ཤེས	Divisions: (1) conceptual mistaken consciousness; (2) non-conceptual mistaken consciousness
མ-ཡིན-དགག-གི-གཞན-སེལ	Divisions: (1) factual other-eliminator that is a specifically characterized phenomenon; (2) mental other-eliminator
མེད-དགག	Divisions: (1) non-affirming negative whose object of negation occurs among objects of knowledge; (2) non-affirming negative whose object of negation does not occur among objects of knowledge
མི	Divisions: (1) men of the four great continents; (2) men of the eight smaller continents
མིག-གི-རྣམ-པར-ཤེས-པ	mind only
མིག-གི-རྣམ-ཤེས	mind only
མིག-ཤེས	Divisions: both mind and mental factors
མངོན-སུམ	Div.: (1) sense direct perceiver; (2) mental direct perceiver; (3) self-knowing direct perceiver; (4) yogic direct perceiver
མངོན-སུམ-བཅད-ཤེས	Div.: (1) sense direct subsequent cognizer; (2) mental direct subsequent cognizer; (3) self-knowing direct subsequent cognizer; (4) yogic direct subsequent cognizer
མངོན-སུམ-ལྟར-སྣང	Div.: (1) mistaken conception; (2) conventional conception; (3) inferential conception; (4) conception arisen from inference; (5) memory conception; (6) wishing conception; (7) non-conceptual counterfeit direct perception
མཚམས-མེད-ལྔ	Div.: 1) Killing one's father, 2) Killing one's mother, 3) Killing a foe destroyer, 4) With bad intention, causing blood to flow from the body of a Buddha, 5) Causing dissension in the spiritual community
མཚན-ཉིད-གསུམ	Div.: the other-powered character, the imputational character, and the thoroughly established character
ནང-གི-འབྱོར-བ-ལྔ	Div.: 1) Birth as a human, 2) Birth in a center of Buddhist teaching, 3) Possessing sound faculties, 4) Freedom from having done any of the five heinous crimes, 5) Faith in the doctrine
ནང-གི-བེམ-པོ	Divisions: (1) eye sense-power; (2) ear sense-power; (3) nose sense-power; (4) tongue sense-power; (5) bodily sense-power
ནང-གི-སྐྱེ-མཆེད-དྲུག	Div.: 1) eye sense power, 2) ear sense power, 3) nose sense power, 4) tongue sense power, 5) body sense power, and 6) mental sense power
ཉན-ཐོས-ཀྱི-མི-སློབ-ལམ	Divisions: (1) exalted knower of a Foe Destroyer who has simultaneous abandonment; (2) exalted knower of a Foe Destroyer who has gradual abandonment;  · Divisions by way of faculty: (1) exalted knowers of Hearer Foe Destroyers with sharp faculties; and (2)
ཉན-ཐོས-ཀྱི-མཐོང-ལམ	Divisions from the point of view of entity: (1) exalted wisdom of meditative equipoise of a Hearer's path of meditation; (2) exalted wisdom of subsequent attainment of a Hearer's path of meditation; (3) Hearer's path of meditation that is neither of those
ཉན-ཐོས-ཀྱི-མཐོང-ལམ-བར-ཆད-མེད-ལམ	Divisions: the eight forbearances of a Hearer's path of seeing (the four doctrinal forbearances and the four subsequent forbearances)
ཉན-ཐོས-ཀྱི-མཐོང-ལམ-མཉམ-བཞག-ཡེ-ཤེས	Divisions:(1) uninterrupted path of a Hearer path of seeing; (2) path of release of a Hearer path of seeing; (3) exalted wisdom of meditative equipoise of a Hearer path of seeing that is neither of those two
ཉན-ཐོས-ཀྱི-སྦྱོར-ལམ	Divisions: Hearer's (1) heat; (2) peak; (3) forbearance; (4) supreme mundane qualities paths of preparation
ཉན-ཐོས-ཀྱི-སྒོམ-ལམ	Divisions: (1) exalted wisdom of meditative equipoise of a Hearer's path of meditation; (2) exalted wisdom of subsequent attainment of a Hearer's path of meditation; and (3) Hearer's path of meditation that is neither of those two
ཉན-ཐོས-ཀྱི-སྒོམ-ལམ-བར-ཆད-མེད-ལམ	Divisions [consist of] the nine ranging from the small of the small up to the great of the great of a Hearer path of meditation
ཉན-ཐོས-ཀྱི-སྒོམ-ལམ-མཉམ-བཞག-ཡེ-ཤེས	Divisions: (1) uninterrupted paths of Hearer's paths of meditation; (2) paths of release of Hearer's paths of meditation; and (3) exalted wisdoms of meditative equipoise of Hearer's paths of meditation that are neither of those two
ཉན-ཐོས-ཀྱི-ཚོགས-ལམ	Divisions: (1) great; (2) middling; (3) small
ཉེ-ཉོན-ཉི-ཤུ	Divisions: (1) belligerence (krodha); (2) resentment (upanāha); (3) concealment (mrakṣa); (4) spite (pradāsa); (5) jealousy (phrag dog, īrṣyā); (6) miserliness (ser sna, mātsarya); (7) deceit (māyā); (8) dissimulation (śāṭhya); (9) haughtiness (mada); (10
ཉེར-བསྡོགས	Divisions—for the first concentration, the "not unable": (1) mental engagement of a beginner; (2) mental engagement of individual investigation of characteristics; (3) mental engagement of belief; (4) mental engagement of thorough isolation; (5) mental en
ཕུང-པོ	Divisions: (1) form (rūpa); (2) feeling (vedanā); (3) discrimination (saṃjñā); (4) compositional factors (saṃskāra); (5) consciousness (vijñāna)
ཕྱག-རྒྱ	Divisions: [The Four Seals that determine whether a doctrine is Buddhist are] (1) all produced phenomena are impermanent; (2) all contaminated phenomena are miserable; (3) all phenomena are empty and selfless; (4) nirvāṇa is peace and bliss
ཕྱིའི-འབྱོར-བ-ལྔ	Div.: 1) A Buddha having appeared in one's world system, 2) A Buddha having taught the doctrine, 3) That Buddha's teaching remaining to the present time, 4) That Buddha's followers still existing, 5) The people of the area having love and mercy for others
ཕྱིའི-བེམ-པོ	Divisions:  (1) form; (2) sound; (3) scent; (4) taste; and (5) tangible object
ཕྱིའི-གཟུགས	Division: (1) form sense-sphere; (2) sound sense-sphere; (3) odor sense-sphere; (4) taste sense-sphere; (5) tangible object sense-sphere
ཕྱིའི-སྐྱེ-མཆེད-དྲུག	Divisions: (1) forms; (2) sounds; (3) odors; (4) tastes; (5) tangible objects; (6) [other] phenomena
རབ-ཏུ-བྱུང-བ	Divisions: (1) monk; (2) nun; (3) śramaṇa; (4) śramaṇā
རགས-པ	extended objects which are reknown to the world{GD:158}  and, extended objects which are reknown to [philosophical] treatises {GD:158}
རང-ལས-ངེས-ཀྱི-ཚད-མ	Div.: (1) sense direct prime cognizers having a familiar object; (2) sense direct prime cognizers to which the ability to perform a function appears; (3) self-knowing direct prime cognizers; (4) yogic direct prime cognizers; (5) inferential prime cognizer
རང-རྒྱལ-གྱི-མི-སློབ-ལམ	Divisions: (1) Solitary Realizer paths of no more learning of those who previously had the realizations of rhinoceros-like Solitary Realizers; (2) Solitary Realizer paths of no more learning of those who previously had the realizations of congregating Sol
རང-རིག-མངོན-སུམ	Definition: (1) direct perceiver that is a self-knowing direct perceiver; (2) subsequent cognizer that is a self-knowing direct perceiver; (3) awareness to which an object appears but is not ascertained that is a self-knowing direct perceiver
རྫུ-འཕྲུལ-གྱི-རྐང-པ	Divisions: (1) aspiration to the bases of magical emanations (chanda-ṛddhi-pada); (2) effort toward the bases of magical emanations (vīrya-ṛdddhi-pada); (3) mental attention on the bases of magical emanations [involving fixing one's mind in the position r
རེག-བྱ	Divisions: (1) tangible object which is an element; (2) tangible object arisen from elements
རྒྱུ	Terminological Div.: (1) creative cause; (2) co-arisen cause; (3) cause of equal/similar lot; (4) associational cause; (5) omnipresent cause; (6) fruitional cause
རྒྱུ-མཐུན-གྱི-འབྲས-བུ	Div.: (1) causally concordant effect in terms of experience; (2) causally concordant effect in terms of performance
རྒྱུད-བཞི	Enumeration: 1) Root Tantra, 2) Explanatory Tantra, 3) Oral Tradition Tantra, 4) Last Tantra
རིག-པའི-གནས	five lesser sciences: ; five greater sciences: crafts; medicine; grammar and etymology; logic and reasoning; inner meaning?
རིགས-གཅིག-པ	Divisions: (1) one isolate type; (2) one substantial type
རིགས-ཚོགས-དྲུག	Divisions: (1) Precious Garland (ratnāvalī); Refutation of Objections (vigraha-vyāvartaṇī); Seventy Stanzas on Emptiness (śūnyatā-saptati); Sixty Stanzas on Reasoning (yuktiṣaṣṭikā); The Finely Woven (vaidalya-sūtra); Treatise on the Middle Way (prajñāmūl
རྗེས-དཔག	Divisions: (1) inference through belief (āpta-anumāna); (2) inference through renown (prasiddha-anumāna); (3) inference by the power of the fact (vastu-bala-anumāna)
རྗེས-མཐུན	Divisions: (1) concordance with concordant phenomenon; (2) concordance with isolate phenomenon that is itself; (3) (2) concordance with isolate phenomenon that is not itself; (4) (2) concordance with isolate phenomenon that is a mere third possibility
རྐྱེན	Div.: (1) observed-object condition; (2) proprietary condition/dominant condition; (3) immediately preceding condition; (4) causal condition
རྣལ-འབྱོར-གྱི-ས	Divisions: (1) yogic ground of one who realizes the selflessness of persons; (2) yogic ground of one who realizes the emptiness of duality; (3) the yogic ground of one who realizes the emptiness of true establishment [of phenomena]
རྣལ-འབྱོར-མངོན-སུམ	Divisions: (1) Hearer yogic direct perceiver; (2) Solitary Realizer yogic direct perceiver; (3) Mahāyāna yogic direct perceiver
རྣམ-མཁྱེན-སྦྱོར-བའི-ངོ-བོ-ཉིད-བདུན	essential of observing bases and paths (gzhi lam la dmigs pa'i ngo bo nyid), essential of nonagreement with everything worldly ('jig rten thams cad dang mi mthun pa'i ngo bo nyid), essential of unimpededness (thogs ma med pa'i ngo bo nyid), essential of the nonexistence of a basis [of mistake] (gzhi med pa'i ngo bo nyid), essential of nongoing ('gro ba med pa'i ngo bo nyid), essential of nonproduction (skye ba med pa'i ngo bo nyid), essential of nonobservation of suchness [as ultimately existent] (de bzhin nyid mi dmigs pa'i ngo bo nyid)
རྣམ-པར-གྱུར-པ	Branches: 1) Cause Branch, 2) Condition Branch, 3) Entrance Branch, 4) Location Branch, 5) Pathways Branch, 6) Time of Arising Branch, 7) Fatal Effect Branch, 8) Side Effects Branch, 9) Condensation Branch
རྣམ-པར-མ-གྱུར-པ	Branches: 1) Humours Branch, 2) Physical Constituents Branch, 3) Excretions Branch
རྣམ-སྨིན-གྱི-རྒྱུ	Divisions: (1) impelling karma; (2) completing karma
རྟག-པ	Divisions: (1) permanent phenomenon that abides all the time; (2) occasional permanent; or: (1) permanent phenomenon whose occurrence is possible; (2) permanent phenomenon whose occurrence is impossible
རྟོག-མེད-ལོག-ཤེས	Division: (1) non-conceptual mistaken consciousness that is a sense consciousness; (2)  non-conceptual mistaken consciousness that is a mental consciousness
རྟོག-མེད-མངོན-སུམ-ལྟར-སྣང	Div.: (1) counterfeit direct perception that is a mental consciousness; (2) counterfeit direct perception that is a sense consciousness
རྟོག-པ-བཅད-ཤེས	Divisions: (1) conceptual subsequent cognizer that is induced by direct perception; (2) conceptual subsequent cognizer that is induced by inference
རྟོན-པ	Divisions: (1) do not rely on the person; rely on the doctrine; (2) do not rely on the words; rely on the meaning; (3) do not rely on the interpretable meaning; rely on the definitive meaning; (4) do not rely on consciousness; rely on exalted wisdom
རྩ-བའི-ཁ-དོག	Divisions: (1) white; (2) yellow; (3) red; (4) blue}
རྩ-ཉོན	Divisions: (1) desire (rāga); (2) anger (pratigha); (3) pride (māna); (4) ignorance (avidyā); (5) doubt (vicikitsā); (6) afflicted view (kliṣṭa-dṛṣṭi)
རྩ-བའི-ཉོན-མོངས	Divisions: (1) desire (rāga); (2) anger (pratigha); (3) pride (māna); (4) ignorance (avidyā); (5) doubt (vicikitsā); (6) afflicted view (kliṣṭa-dṛṣṭi)
ས-བཅུ	Div: 1. Very Joyful (pramuditā), 2. Stainless (vimalā), 3. Luminous (prabhākarī), 4. Radiant (arciṣmatī), 5. Difficult to Overcome (sudurjayā), 6. Manifest (abhimukhī), 7. Gone Afar (dūraṃgama), 8. Immovable (acalā), 9. Good Intelligence (sādhumatī), 10.
ས-གསུམ	Divisions: (1) below the ground; (2) above the ground; and (3) on the ground
ས-སྡེ	Div.: (1) Levels of Yogic Practice (yogācārya-bhūmi); (2) Compendium of Ascertainments (nirṇaya-saṃgraha); (3) Compendium of Bases (vastu-saṃgraha); (4) Compendium of Enumerations (paryāya-saṃgraha); (5) Compendium of Explanations (vivaraṇa-saṃgraha); may
སྦྱོར-བཞི་།-སྦྱོར-བ-བཞི	complete training in all aspects (rnam kun mngon rdzogs sbyor ba), peak training (rtse mo'i sbyor ba), serial training (mthar gyis pa'i sbyor ba), and  momentary training (skad cig ma'i sbyor ba)
སྦྱོར-ལམ	Divisions: (1) heat; (2) peak; (3) forbearance; (4) supreme mundane qualities
སྡེ-བདུན	Divisions: (1) Analysis of Relations ('brel pa brtag pa'i rab tu byed pa, saṃbanda-parīkṣāvṛtti); (2) Ascertainment of Valid Cognition (tshad ma rnam par nges pa, pramāṇa-viniścaya); (3) Commentary on (Dignāga's) 'Compendium of Valid Cognition' (tshad ma
སེལ-འཇུག	Div.:(1) mind that is an eliminative engager; (2) sound that is an eliminative engager; (3) person that is an eliminative engager
སེམས-བསྐྱེད	Div.: 1) [mind-generations of] pure imagination, 2) [mind-generations that are] pure unusual attitudes, 3) aspirational mind-generations, 4) mind-generations that have abandoned the obstructions
སེམས-བྱུང	Div.: (1) five omnipresent (sarvatraga) mental factors; (2) five determining (viṣaya-pratiniyama) mental factors; (3) eleven virtuous (kuśala) mental factors; (4) six root afflictions (mūla-kleśa); (5) twenty secondary afflictions (upakleśa); and (6) four
སྒོམ-ལམ	Syn.: exalted knower of one on the path of meditation; subsequent clear realizer
སྒྲུབ-འཇུག	Div.: According to Jay-tsün-pa: (1) non-conceptual prime/valid cognition; (2) person who is a collective/complete/holistic engager
ཤེས-པ	Divisions: (1) sense cognition; (2) mental cognition
སྐབས-འདིར-བསྟན-གྱི-ཡིད-མངོན	Div.: the five ranging from mental direct perceptions apprehending forms through to mental direct perceptions apprehending tangible objects [the other three are mental direct perceptions apprehending sounds, scents, and tastes]
སྐྱེ-མཆེད	Div: external sense-spheres (i.e., the six sense-spheres of forms, sounds, odors, tastes, tangible objects, and [other] phenomena) and internal sense-spheres (i.e., the six sense-spheres of the eye, ear, nose, tongue, body, and mental sense powers)
སྣང-བ-རྣམ-བདུན	dream, magical illusion, mirage, echo, reflection, city of smell-eaters, and emanation 
སྣང-ལ-མ-ངེས-པའི-བློ	Divisions: (1) sense direct perceiver which is that; (2) mental direct perceiver which is that; (3) self-knower which is that
སྙན-ཐོས-ཀྱི-མཐོང-ལམ-རྣམ-གྲོལ-ལམ	Divisions: eight Hearer cognitions (four doctrinal cognitions and four subsequent cognitions)
སྙན-ཐོས-ཀྱི-སྒོམ-ལམ-རྣམ-གྲོལ-ལམ	Divisions: (1) those done in terms of a person who has gradual objects of abandonment; (2) those done in terms of a person who has simultaneous objects of abandonment
སོ-སོའི-སྐྱེ-བོ	Div.: (1) hell-beings; (2) hungry ghosts; (3) animals; (4) people; (5) demi-gods; (6) gods
སོར-མོ-ལྔ	Div.: thumb; index finger; middle finger; ring finger; little finger
སྤྱི	Divisions: (1) type generality; (2) meaning generality; (3) collection generality
ཐ-སྙད	{GD:726} Div.: (1) verbal designations for a name applied to an object; (2) mental labels designating the consciousness that relates a name to an object; (3) physical signs through which one can communicate
ཐལ-འགྱུར	Div.: (1) correct consequence; (2) facsimile of a consequence
ཐལ-འགྱུར-ཡང-དག	Div.: (1) correct consequence that impels a proof; (2) correct consequence that does not impel a proof
ཐེ-ཚོམ	Div.: (1) doubt tending toward the fact; (2) doubt not tending toward the fact; (3) equal doubt
ཐེག-ཆེན-གྱི-མི-སློབ-ལམ	Div.: (1) exalted knowers of all aspects that know the mode; (2) exalted knowers of all aspects that know the varieties; or: (1) mirror-like exalted wisdom; (2) exalted wisdom of sameness; (3) exalted wisdom of individual realization; (4) exalted wisdom o
ཐེག-ཆེན-གྱི-སྒོམ-ལམ	Div.: (1-4) the four smaller cycles; (5-7) the three middling cycles; (8-11) the four greater cycles
ཐེག-ཆེན-གྱི-སྒོམ-ལམ-བར-ཆད-མེད-ལམ-ཆུང-ངུའི-ཆུང-ངུ	Div.: (1) the uninterrupted path of a path of meditation of the first ground; (2) the uninterrupted path of a path of meditation of the second ground
ཐེག-པ-གསུམ	Div.: (1) Hearer Vehicle (śrāvaka-yāna); (2) Solitary Realizer Vehicle (pratyekabuddha-yāna); and (3) Bodhisattva Vehicle (bodhisattva-yāna)
ཚད-མ	Divisions: (1) direct valid cognizer; (2) inferential valid cognizer
ཚད-མེད-བཞི	Div.: 1) immeasurable compassion, 2) immeasurable love, 3) immeasurable joy, 4) immeasurable equanimity
ཚད-མིན-གྱི-ཤེས-པ	Divisions: (1) subsequent cognizer; (2) mental engagement; (3) awareness to which an object appears but is not ascertained; (4) doubting consciousness; (5) mistaken consciousness
ཚུལ-གསུམ	Divisions: (1) subject-quality (pakṣadharmatvam) [the presence of the reason in the subject, that is to say, the reason applies to the subject: (A) In the case of the subject, the color of a white religious conch, / (B) it follows that it is red / (C) bec
ཡང-དག-པར-སྤོང-བ	(1) abandoning of afflictions already produced; (2) non-generation of afflictions not yet generated; (3) increasing of pure phenomena already generated; (4) generation of pure phenomena not yet generated
ཡི-དགས	Div.: (1) having later obstructions; (2) having present obstructions; (3) having both later and present obstructions
ཡི-དྭགས	Divisions: (1) having later obstructions; (2) having present obstructions; (3) having both later and present obstructions
ཡིད-མངོན	Divisions: (1) mental direct perceivers indicated on this occasion; (2) mental direct perceivers not indicated on this occasion
ཡོན-ཏན-གསུམ	Div.: 1) lightness (sattva), 2) motility (rajas), 3) darkness (tamas)
ཡོངས-གྲུབ	Div.: (1) emptiness of apprehended object and apprehending subject's being different substantial entities; (2) imputations that are imputations as entity and attributes; (3) emptiness of [the other-powered nature's] being established by way of its own cha
ཡུལ-དུརག	Div.: form, sound, smell, taste, tangible object, phenomenon
ཡུལ-ངེས	Divisions: (1) aspiration (chanda); (2) belief (adhimokṣa); (3) mindfulness (smṛti); (4) meditative stabilization (samādhi); (5) wisdom (prajñā)
ཟས	Divisions: (1) material food; morsels (kavalikāhāra){LWT 99}; (2) food of touch (sparśāhāra); (3) food of intention (manaḥ-saṃcetanāhāra);   (4) food of consciousness (vijñānāhāra)
ཞུགས-གནས	Divisions: (1,2) approacher and abider in the fruit of a Stream Enterer; (3,4) approacher and abider in the fruit of a Once Returner; (5,6) approacher and abider in the fruit of a Never Returner; (7,8) approacher and abider in the fruit of a Foe Destroyer
