ཀུན-ཉོན	Affliction
ཀུན-བཏགས-པའི-གཟུགས	Imagined forms
ཀུན-རྟོག	conceptualizations
ཀུན-ནས-མནར-སེམས-པ	hostile attitude
ཀུན-འབྱུང-གི-བདེན-པ	truth of origin, as interdependent links
ཀུན-གཞི	All-ground
ཀུན-གཞིའི-རྣམ-ཤེས	 All-ground consciousness, as one of the eight collections of cognitions|All-ground consciousness 
རྐྱེན-དང-འབྲེལ-བ-དྲུག	six related conditions
སྐད-ཅིག-མའི-རྟེན-འབྲེལ	interdependence of a moment
སྐལ-མཉམ	see also similar class - same status, as one of the fourteen non-concurrent formations
སྐྱེ-མཆེད-བཅུ-གཉིས	twelve sources
སྐྱེ-མཆེད-དྲུག	six sources, as one of the twelve links
སྐྱེ-བ	 Arising, as one of the fourteen non-concurrent formations; alt: (birth)|rebirth, as one of the twelve links 
སྐྱེ-བའི-ཀུན-ནས-ཉོན-མོངས-པ	Affliction of rebirth
སྐྱེས-བུ-ཁམས-དྲུག-པ	six elements of a person
ཁ-དོག-གི-གཟུགས	color-forms
ཁམས	element
ཁམས-བཅོ-བརྒྱད	eighteen elements
ཁོང-ཁྲོ	Anger
ཁོང-ཁྲོ-བ	Anger, as one of the six root disturbances
ཁོན-དུ-འཛིན-པ	Resentment, as one of the twenty subsidiary disturbances
ཁྱད-པར-གྱི-ཆོས	specific attributes
ཁྱད-གཞི-ཆོས-ཅན	basis of specifics possessing attributes
ཁྲུ-གང	cubit
ཁྲེལ-མེད-པ	Shamelessness, as one of the twenty subsidiary disturbances
ཁྲེལ-ཡོད-པ	Shame, as one of the eleven virtuous mental states
ཁྲོ-བ	Fury, as one of the twenty subsidiary disturbances
འཁོར-སེམས-བྱུང-གི-གཞི	Accompanying basis of mental states, as one of the fivefold basis of knowables
གོ-རིམ	Sequence, as one of the ten non-concurrent formations
གྲངས	Number, as one of the ten non-concurrent formations
གླང-གི-རྡུལ	cow particle
དགག-སྒྲུབ-ཀྱི-ཡན-ལག-བཞི	four aspects of refuting and establishing
དགེ-རྒྱས	Full Beauty
དགེ-བའི-རྩ-བ	virtuous roots
དགེ-བའི-སེམས-བྱུང-བཅུ-གཅིག	eleven virtuous mental states
དགེ-མི-དགེ-ལུང-མ-བསྟན	virtuous, unvirtuous or neutral
མགྱོགས-པ	Speed, as one of the ten non-concurrent formations
འགལ-བ-གཉིས	two types of opposition
འགལ-འབྲེལ	opposed and related things
འགལ-ཟླ-ཅིག-ཤོས	opposite factor
འགལ-ཟླའི-ཁྱབ-བྱ	object embraced by the opposite
འགོག-བདེན	truth of cessation, as interdependent links
འགོག-པའི-སྙོམས-འཇུག	serenity of cessation, as one of the fourteen non-concurrent formations
འགྱོད-པ	Regret, as one of the four variables
རྒ-བ	Aging, as one of the fourteen non-concurrent formations
རྒ-བ-འཆི-བ	old age and death, as one of the twelve links
རྒོད-པ	Excitement, as one of the twenty subsidiary disturbances
རྒྱ-ཆེན-པོའི-འདུ-ཤེས	vast perception
རྒྱགས-པ	Self-infatuation, as one of the twenty subsidiary disturbances
རྒྱང-གྲགས	mile
རྒྱས-བྱུང	development, as one of the three occurrences
རྒྱུ-མཐུན	causal resemblance, as one of the three occurrences
རྒྱུ-དང-བཅས-པ	basis for the causes
རྒྱུ-དང-འབྲེལ-བ	related causes, of inner interdependence
རྒྱུ-དང-འབྲེལ-བ-བདུན	seven related causes
རྒྱུ-འབྲས-ཀྱི-རྟེན-འབྲེལ	interdependence of cause and effect
རྒྱུ-གཟུགས-བཞི	four causal forms
རྒྱུན-ཆགས-པའི-རྟེན-འབྲེལ	continuous interdependence
རྒྱུན-བརྟན-པ	steady continuance
སྒོ-ལྔའི-ཤེས-པ	consciousnesses of the five sense-doors
སྒྱུ	Pretense, as one of the twenty subsidiary disturbances
སྒྲ	Sounds
སྒྲ-དོན	sound object
སྒྲ-རྡུལ	sound particle
སྒྲ-སྤྱི	sound-image
སྒྲུབ-ཚུལ-གྱི-ཐ-སྙད	designations of the ways of establishing
བརྒྱུད-འགལ	indirect opposition
ང-རྒྱལ	Arrogance, as one of the six root disturbances
ངེས-པ	Ascertainment
ངེས-པར-འབྱུང-བ	emancipation
ངེས-པར-འབྱུང-བ-དང-བཅས-པ	basis for renunciation
ངེས-འབྱིན	causing emancipation
ངེས-ཤེས	certain knowledge
ངོ-བོ	identity
ངོ-བོ-དང-བྱེད-ལས	identity and function
ངོ-ཚ-མེད-པ	Lack of conscience, as one of the twenty subsidiary disturbances
ངོ-ཚ-ཤེས-པ	Conscience, as one of the eleven virtuous mental states
དངོས-འགལ	direct opposition
དངོས-པོ	things, [concrete functional]
དངོས-མེད	non-things - [inconcrete, nonfunctional]
མངོན-པར-སྐབས-ཡོད-པའི-གཟུགས	Spatial form
མངོན-པར-གྲུབ-པའི-ཡན-ལག	fully established links
མངོན-པར-འགྲུབ-པའི-ཡན-ལག	fully establishing links
མངོན-འབྱུང-རྟེན-པའི-ཚོར-བ	sensations that support deliverance
མངོན-སུམ-སྣང-ལ-མ-ངེས-པ	direct perception without ascertainment
མངོན-སུམ-ཚད-མ	valid direct perception
ཅི-ཡང-མེད-པའི-སྐྱེ-མཆེད	sphere of nothing whatsoever
ཅི-ཡང-མེད-པའི-འདུ-ཤེས	perception of nothing whatsoever
གཅིག-པུ	singular
བཅད-ཤེས	decisiveness
ལྕགས-རྡུལ	iron particle
ཆགས-སྡང-གཏི-མུག	Attachment, aggression and delusion
ཆད-པ	 discontinuance|discontinuous 
ཆུ-ཁམས	water element
ཆུ-རྡུལ	water particle
ཆུང-ངུའི-འདུ-ཤེས	lesser perception
ཆོས	 phenomena, as mental objects|mental object 
ཆོས-ཀུན-གྱི-ཡུལ-ཅན	subject of all phenomena
ཆོས-ཀྱི-སྐྱེ-མཆེད	 mental object sources|mental object source 
ཆོས-ཀྱི-སྐྱེ-མཆེད-པའི-གཟུགས	forms that are mental objects
ཆོས-ཀྱི-སྐྱེ-མཆེད-པའི-གཟུགས-ལྔ	five types of forms that are mental objects
ཆོས-ཀྱི-ཁམས	 element of mental objects, as one of the eighteen elements|mental object elements 
ཆོས-ཀྱི-དབྱིངས	 realm of phenomena, dharmadhatu|Dharmadhatu, as suchness 
ཆོས-ཁམས	element of mental objects
ཆོས-ཁམས-བཅུ-དྲུག	sixteen elements of mental objects
ཆོས-ཁམས-བདུན	elements of mental objects
མཆོག-འཛིན-གཉིས	two types of holding to be paramount
འཆབ-པ	Concealment, as one of the twenty subsidiary disturbances
འཇིག-ལྟ	belief in the transitory collection
འཇིག-ཚོགས-ལ-ལྟ-བ	belief in the transitory collection, as one of the five beliefs
འཇིགས-སྲེད	fearful craving
འཇུག-ལྡོག	engagement in and disengagement from
འཇུག-པ	Regular sequence, as one of the ten non-concurrent formations
འཇུག-ཡུལ	engaged object, as one of the four types of objects
འཇུག-ཤེས-དྲུག	six kinds of engaged cognitions
རྗེས-དཔག-ཚད-མ	valid inference
རྗེས-དཔག-ཚད-མ-ལ-མ-བརྟེན-པའི-ཡིད-དཔྱོད	Assumption not supported by valid inference
རྗེས-སུ-འགྲོ-ལྡོག	engagement and disengagement
རྗོད-བྱེད	describing [word]
བརྗེད-ངས	Forgetfulness, as one of the twenty subsidiary disturbances
བརྗོད-བྱ-རྗོད-བྱེད	described and describing
ཉི-ཟེར-གྱི-རྡུལ	sunbeam particle
ཉེ-ཉོན-ཉི-ཤུ	twenty subsidiary disturbances
ཉེ-བར-ལེན-པ-བཞི	four graspings
ཉེ-བར-ལེན-པའི-རྣམ-ཤེས	perpetuating consciousness
ཉེ-བར-ལེན-པའི-ཕུང-པོ-ལྔ	five perpetuating aggregates
ཉོན-མོངས-པའི-གཞན-དབང	dependency of disturbance
ཉོན-མོངས-པའི-ཡིད-ཀྱི-རྣམ-ཤེས	disturbed mental cognition, as one of the eight collections of cognitions
ཉོན-མོངས-པས-ཀུན-ནས-ཉོན-མོངས	Affliction through disturbance
ཉོན-ཡིད	disturbed mental cognition
གཉིད	Sleep, as one of the four variables
སྙིང-རྗེ-བའི-སེམས	compassionate attitude
སྙོམས-འཇུག	serenity
སྙོམས-འཇུག-གཉིས	two serenitys
ཏིང-ངེ-འཛིན	Concentration, as one of the five object determining mental states
གཏི-མུག-མེད-པ	Non-delusion, as one of the eleven virtuous mental states
བཏགས-པ	imputations
བཏང-སྙོམས	 Equanimity, as one of the eleven virtuous mental states|indifference 
རྟག-པ-དང-ཆད-པ	permanent or discontinuous
རྟེན-ཅིང-འབྲེལ-བར-འབྱུང-བ	dependent origination
རྟེན-འབྲེལ-ཁྱད-པར-ལྔ	five special features of interdependence
རྟེན-འབྲེལ-གྱི-སྣང-བ-བསླུ-མེད	unfailing manifestation of interdependence
རྟེན-འབྲེལ-ཡན-ལག-བཅུ-གཉིས	 twelve aspects of interdependence|twelve links of interdependence 
རྟེན-འབྲེལ-ལུགས-ལྡོག	interdependent links in reverse order
རྟོག-བཅས-ཀྱི-ཁམས	elements with concepts
རྟོག-བཅས-ཀྱི-ཤེས-པ	 conceptual - [mental] cognition|conceptual cognition 
རྟོག-བཅས-རྟོག-མེད	conceptual and nonconceptual
རྟོག-པ	Concept, as one of the four variables
རྟོག-པ-དང-དཔྱོད-པ	conception and discernment, concerning the 18 elements
རྟོག-མེད-ཀྱི-ཤེས-པ	 mental cognition, nonconceptual|nonconceptual - [mental] cognition 
རྟོག-མེད-ཤེས-པ	nonconceptual cognition
ལྟ-བ	Belief, as one of the six root disturbances
ལྟ-བ-མཆོག-འཛིན	Holding a belief to be paramount, as one of the five beliefs
ལྟ-བའི-གནས	ground of beliefs
ལྟུང-བ	downfalls
སྟོང-གཉིས	two-thousandfold universe
སྟོང-གསུམ	three-thousandfold universe
བརྟན-པ-ཀུན-གཞི	ongoing all-ground
བསྟན-དུ-ཡོད-པའི-ཁམས	demonstrable element
ཐ-སྙད	 designations|designations 
ཐ-སྙད-བྱེད-པའི-ཚུལ-བཞི	four ways of making designations
ཐ-སྙད-ལ-མི-མཁས-པ	lack of skill in designations
ཐར-པ	emancipation
ཐེ-ཚོམ	 Doubt, as one of the six root disturbances|Doubting, as one of four types of cognition 
ཐོབ-པ	Acquisition, as one of the fourteen non-concurrent formations
ཐོས-པའི-ཐ-སྙད	designation of hearing
མཐར-འཛིན-པའི-ལྟ-བ	belief of holding extremes, as one of the five beliefs
མཐོང-བའི-ཐ-སྙད	designation of seeing
འཐབ-པ-དང-བཅས-པ	basis for strife
དད-པ	Faith, as one of the eleven virtuous mental states
དུས	 Time, as one of the ten non-concurrent formations|Time, as creator 
དུས-དང-གཏམ-གྱི-གཞི	basis for talk and time
དེ-བྱུང-འབྲེལ	resultant relationship
དེ-མཚུངས	resemblance, concerning the sense faculties
དེ-བཞིན-ཉིད	def. suchness, as one of the four unconditioned things
དོན-གྱི-སྤྱི	general object-image
དོན-འགལ	factual opposition
དོན-ལྔ	five sense objects
དོན-སྤྱི	object-image
དོན-རང-མཚན-གྱི-གཞན-སེལ	other-exclusion of the object's individual characteristics
དྲན-པ	Recollection, as one of the five object determining mental states
དྲན-པ-འཆལ-བ	erroneous mindfulness
དྲི	Odors
བདག	 self-entity|Self, as creator 
བདག-རྐྱེན	ruling condition
བདག-གཅིག-འབྲེལ	Same entity relationship
བདག-མེད-པའི-འདུ-ཤེས	perception of non-self
བདེ-བ	pleasure
བདེན-དོན-རྣམ-པ-བཅུ-གཉིས	twelvefold points of truth
འདུ-བྱེད	formation, as one of the twelve links
འདུ-བྱེད-ཀྱི-ཕུང-པོ	Aggregate of formations
འདུ-ཤེས	perceptions
འདུ-ཤེས-ཀྱི-ཕུང-པོ	Aggregate of perceptions
འདུ-ཤེས-མེད-པ	state of non-perception, as one of the fourteen non-concurrent formations
འདུ-ཤེས-མེད-པའི-སྙོམས-འཇུག	 Perceptionless serenity, as one of the fourteen non-concurrent formations|serenity of non-perception 
འདུ-ཤེས-མེད-པའི-ལྷ	perceptionless gods
འདུན-པ	 inclination|Intention, as one of the five object determining mental states 
འདུས-བྱས	conditioned things
འདུས-བྱས-སུ-མཚོན-པའི-མཚན-ཉིད-བཞི	four characteristics that indicate conditioned things
འདུས-མ-བྱས	unconditioned things
འདུས-མ-བྱས-ཀྱི-གཞི	basis of unconditioned things, as one of the fivefold basis of knowables
འདུས-མ-བྱས-བརྒྱད	eight unconditioned things
འདུས-མ-བྱས-བཞི	four unconditioned things
འདུས-མ-བྱས-གསུམ	three unconditioned things
འདོད-ཆགས	Attachment, as one of the six root disturbances
འདོད-པའི-འདོད-ཆགས	Attachment of desire
འདོད-ཡོན-ལྔ	five sense pleasures
འདོད-སྲེད	desirous craving
རྡུལ-ཕྲ-རབ	most subtle atoms
རྡུལ-ཕྲན	particle
ལྡན-མིན	non-concurrences; see also: non-concurrent formation - {ldan min 'du byed}
ལྡན-མིན-འདུ-བྱེད	non-concurrent formations
ལྡན-མིན-འདུ-བྱེད-ཀྱི-གཞི	nonconcurrent formation basis, as one of the fivefold basis of knowables
ལྡན-མིན-འདུ-བྱེད-ཉེར-བཞི	twenty-four non-concurrent formations
ལྡོག-པ	 disengagement|oppositions 
ལྡོག-པ-ཐ-དད	different opposites
སྡུག-བསྔལ	pain
སྡུག-བསྔལ-གྱི-གཞན-དབང	dependency of suffering
སྡུག-བསྔལ-གྱི-གཞི-བདུན	seven bases of suffering
སྡུག-བདེན	truth of suffering, as interdependent links
བསྡུས-པ-ལས-གྱུར-པའི-གཟུགས	Inferred form
ནང-གི-སྐྱེ-མཆེད-དྲུག	 inner six sources, as one of the twelve links|inner six sources 
ནང-གི-ཁམས	inner elements
ནང-གི-ཆོས	origination of inner phenomena
ནང-གི-རྟེན-འབྲེལ	inner interdependence
ནམ-མཁའ	Space, as one of the eight unconditioned things
ནམ-མཁའ-མཐའ-ཡས-པའི-སྐྱེ-མཆེད	sphere of infinite space
ནམ-མཁའི-ཁམས	space element
གནས-དོན-ལུས	environment, sense objects, and a body
གནས-པ	Subsistence, as one of the fourteen non-concurrent formations
རྣམ-བཅད	elimination
རྣམ-པར-བཅད-པ	eliminated
རྣམ-པར-འབྱེད-པ	discrimination
རྣམ-པར-མི-འཚེ-བ	Non-aggression, as one of the eleven virtuous mental states
རྣམ-པར-སྨིན-པའི-ཀུན-གཞི	All-ground of maturation
རྣམ-པར-སྨིན-པའི-ཀུན-གཞིའི-རྣམ-ཤེས	All-ground consciousness of maturation
རྣམ-པར-འཚེ-བ	Hostility, as one of the twenty subdisturbances
རྣམ-པར-གཡེང-བ	Distraction, as one of the twenty subsidiary disturbances
རྣམ-པར-རིག-བྱེད-ཀྱི-གཟུགས	Perceptible forms
རྣམ-པར-རིག-བྱེད-མིན-པའི-གཟུགས	imperceptible forms
རྣམ-པར-ཤེས-པ-དྲུག	six [collections of] cognitions
རྣམ-པར-ཤེས-པའི-ཁམས-བདུན	seven consciousness elements
རྣམ-པར-ཤེས-པའི-ཕུང-པོ	consciousness aggregate
རྣམ-སྨིན	ripening, as one of the three occurrences
རྣམ-སྨིན-དང-རྒྱས-བྱུང	ripening and development
རྣམ-ཤེས	 consciousness, as compared with cognitive act and mental faculty|consciousness, as one of the twelve links 
རྣམ-ཤེས-ཀྱི-ཕུང-པོ	Aggregate of consciousnesses
རྣམ-ཤེས-ཀྱི-ཕུང-པོ-ལས-ཁམས-བདུན	seven elements from the aggregate of consciousness, as of the eighteen elements
རྣམ-ཤེས-མཐའ-ཡས-པའི-སྐྱེ-མཆེད	sphere of infinite consciousness
རྣམ-ཤེས-ཚོགས-བརྒྱད	div. eight collections of cognitions
སྣང-བ-གཟུགས-ཀྱི-གཞི	form basis of appearance, as one of the fivefold basis of knowables
སྣང-ཡུལ	Apparent object, as one of the four types of objects
དཔག-ཚད	league
དཔྱོད-པ	Discernment, as one of the four variables
སྤྱི	generality
ཕན-ཚུན-ཐོགས-པ-དང-བཅས-པའི-ཁམས	mutually obstructive elements
ཕན-ཚུན-སྤང-འགལ	Mutually exclusive opposition
ཕུང-པོ	Aggregates
ཕྱི-ནང-གི-ཆོས	outer and inner phenomena
ཕྱི-མི-སྐྱེ-བའི-བཟོད-པ	Acceptance of future non-origination
ཕྱིའི-སྐྱེ-མཆེད-དྲུག	outer six sources
ཕྱིའི-ཁམས	outer elements
ཕྱིའི-ཆོས	origination of outer phenomena
ཕྱིའི-རྟེན-འབྲེལ	outer interdependence
ཕྲ-རབ-ཆ-མེད-ཀྱི-རྡུལ	most subtle and partless atoms
ཕྲག-དོག	Envy, as one of the twenty subsidiary disturbances
འཕགས-པ	Noble being
འཕགས-ལམ-བརྒྱད	eightfold noble path
འཕགས-ལམ-མངོན-བྱུང	Actualization of the path of noble beings
འཕངས-འབྲས-ཀྱི-རྣམ-ཤེས	consciousness of the impelled result
འཕངས-འབྲས-ཀྱི-ཡན-ལག	links of the propelled result
འཕེན-པའི-ཡན-ལག	propelling links
འཕེན-བྱེད-ཀྱི-རྣམ-ཤེས	impelling consciousness
བག-མེད-པ	heedlessness, as one of the twenty subsidiary disturbances
བག-ཡོད-པ	conscientiousness, as one of the eleven virtuous mental states
བེམ-པོ	matter
བེམ-ཤེས-ལྡན-མིན	matter, mind and non-concurrences
བྱ-བ-རྫོགས-པའི-སྐད-ཅིག	moment of completing an act
བྱུང-བ-གསུམ	three occurrences
བྱེ-བྲག	Instances
བྱེ-བྲག-ཕྱེད-པའི-ཐ-སྙད	designation of differentiation
བྱེད-པ-པོ-རྟག-པ	permanent creator
བླ-མེད-བྱང-ཆུབ	unexcelled enlightenment
བློ	 cognitive act | four types of cognition| four types of mind | mind |cognition 
བློ-འགལ	mental opposition
བློའི-གཞན-སེལ	mental other-exclusion
དབང-རྟེན	sense faculties
དབང-པོ-ལྔ	five sense faculties
དབང-པོ-རྟེན-བཅས	faculty with support
དབང-པོའི-ཁམས-ལྔ	five elements of the sense faculties, as of the eighteen elements
དབང-ཕྱུག	Almighty, as creator
དབང-འབྱོར-བའི-གཟུགས	Mastered forms
དབྱིབས-ཀྱི-གཟུགས	Shape-forms
འབྱོར-འབྲེལ-བ	Connected link, as one of the ten non-concurrent formations
འབྲས-གཟུགས-བཅུ-གཅིག	eleven resultant forms
འབྲེལ-བ	relationship
མ-ཆགས-པ	Non-attachment, as one of the eleven virtuous mental states
མ-རྟོགས-པའི-བློ	two kinds of not understanding, as one of four types of cognition
མ-ཐོབ-པ	dispossession, as one of the fourteen non-concurrent formations
མ-དད-པ	Lack of faith, as one of the twenty subsidiary disturbances
མ-ཞི-བ	restlessness
མ-ཟིན-པའི-འབྱུང-བའི-རྒྱུ-ལས-བྱུང-བའི-སྒྲ	Sounds originating from unconscious elemental causes
མ-རིག-པ	 Ignorance, as one of the six root disturbances|Ignorance, as one of the twelve links 
མི-དགེ-བའི-སེམས-བྱུང	non-virtuous mental states
མི-རྟག-པ	Impermanence, as one of the fourteen non-concurrent formations
མི-གཡོ-བ	Non-transference
མི-གཡོ-བའི-ལས	non-transferring actions
མི-སློབ-པའི-ས	state of non-learning
མིག-གི-སྐྱེ-མཆེད	eye source, as one of the twelve sources
མིག-གི-ཁམས	eye element, as one of the eighteen elements
མིག-གི-རྣམ-པར-ཤེས-པ	visual cognition, as one of the six collections
མིག-གི-རྣམ-ཤེས-ཀྱི-ཁམས	eye consciousness element, as one of the eighteen elements
མིག-གི-དབང-པོ	eye faculty
མིང-གི-ཚོགས	category of names, as one of the fourteen non-concurrent formations
མིང-བཞི	four names
མིང-བཞིའི-ཕུང-པོ	four name aggregates
མིང-གཟུགས	name-and-form, as one of the twelve links
མེ-ཁམས	fire element
མེད-པ-གསལ-སྣང	nonexistent vivid presence
མེད-མ-ཡིན-དུ-དགག-པ	refuting identity as being absent
མོས-པ	adherence, as one of the five object determining mental states, alt: interest
དམིགས-པ-དང-བཅས-པའི-ཁམས	elements with focus
རྨུགས-པ	Lethargy, as one of the twenty subsidiary disturbances
གཙོ-བོ-སེམས-ཀྱི-གཞི	chief mind basis, as one of the fivefold basis of knowables
རྩ-ཉོན-དྲུག	ten root disturbances
རྩ-བའི-ཉོན-མོངས-པ-དྲུག	six root disturbances
བརྩོན-འགྲུས	diligence, as one of the eleven virtuous mental states
ཚད-མེད-པའི-འདུ-ཤེས	immeasurable perception
ཚིག-གི-ཚོགས	category of words, as one of the fourteen non-concurrent formations
ཚུལ-ཁྲིམས-དང-བརྟུལ-ཞུགས-མཆོག-འཛིན	Holding a discipline or ritual to be paramount, as one of the five beliefs
ཚོགས-དྲུག	six collections [of consciousness/ cognition]
ཚོགས-པ	Gathering, as one of the ten non-concurrent formations
ཚོར-བ	 sensation, as one of the twelve links|sensations 
ཚོར-བ-བཏང-སྙོམས	indifferent sensation
ཚོར-བ-ཟང-ཟིང-བཅས-པ	turbulent sensations
ཚོར-བའི-ཕུང-པོ	Aggregate of sensations
མཚན-ཉིད-མཚོན-བྱ-མཚན-གཞི-གསུམ	characteristic, the characterized, and the characteristic basis
མཚན-མ	distinguishing marks
མཚན-མ-དང-བཅས-པའི-འདུ-ཤེས	perceptions with marks
མཚན-མ-མེད-པའི-འདུ-ཤེས	markless perception
མཚན-མེད-ཀྱི-དབྱིངས-ཀྱི-འདུ-ཤེས	perception of markless space
མཚན-གཞི	characteristic basis
མཚུངས-ལྡན-མིན-པའི-འདུ-བྱེད	non-concurrent formations
མཚོན-བྱ	characterized
འཚིག-པ	Spite, as one of the twenty subsidiary disturbances
འཛིན-པ	 Apprehension|holder 
རྫས-སུ-ཡོད-པ	substantial existence
ཞི-གནས	calm abiding
ཞེ-སྡང-མེད-པ	Non-aggression, as one of the eleven virtuous mental states
ཞེན-པ-རྟེན-པའི-ཚོར-བ	sensations that support clinging
ཞེན-ཡུལ	taken object, as one of the four types of objects
གཞན-འགྱུར-བཞི	four variables
གཞན-སེལ	other-exclusion
གཞུ-འདོམ	fathom
ཟག-བཅས-ཀྱི-ཕུང-པོ	defiling aggregates
ཟག-བཅས-ཉེར-ལེན-གྱི-ཕུང-པོ	Aggregates that perpetuate defilements
ཟག-མེད-ཀྱི-ཁམས	nondefiling elements
ཟང-ཟིང-མེད-པའི-ཚོར-བ	sensations free from turbulence
ཟིན-པའི-འབྱུང-བའི-རྒྱུ-ལས-བྱུང-བའི-སྒྲ	Sounds originating from conscious elemental causes
གཟུགས	 Form | form, as one of name-and-form|Visible forms 
གཟུགས-ཀྱི-སྐྱེ-མཆེད	visible form source
གཟུགས-ཀྱི-ཁམས	element of visible form, as one of the eighteen elements
གཟུགས-ཀྱི-མཐའ	finality of form
གཟུགས-ཀྱི-ཕུང-པོ	 aggregate of forms|form aggregate 
གཟུགས-ཀྱི-ཕུང-པོ-ལས-ཁམས-བཅུ	ten elements from the aggregate of forms, as of the eighteen elements
གཟུགས-ཅན-གྱི-ཁམས-བཅུ	elements having physical form
གཟུང-བ	held
གཟུང-ཡུལ	held object, as one of the four types of objects
ཡང-དག-པར-རྟོགས-པ	Correct understanding, as one of four types of cognition
ཡང-དག-པར-བླངས-པ-ལས-བྱུང-བའི-གཟུགས	Forms resulting from a fully taken promise
ཡན-ལག-བཅུ-གཉིས	twelve links
ཡི-གེའི-ཚོགས	category of letters, as one of the fourteen non-concurrent formations
ཡིད	 cognitive act| mental faculty, as compared with cognitive act and consciousness |Mind 
ཡིད-ཀྱི-སྐྱེ-མཆེད	mind source
ཡིད-ཀྱི-ཁམས	mind element, as one of the eighteen elements
ཡིད-ཀྱི-རྣམ-པར-ཤེས-པ	mental cognition, as one of the six collections
ཡིད-ཀྱི-རྣམ-ཤེས-ཀྱི-ཁམས	mind consciousness element, as one of the eighteen elements
ཡིད-ཀྱི-དབང-པོ	mental faculty
ཡིད-བདེ	mental pleasure
ཡིད-བྱེད	Attention, as one of the five ever-present mental states
ཡིད-མི-བདེ	mental pain
ཡིད-ཤེས	 mental cognition | mental cognitions|mind consciousness 
ཡིད-ཤེས-རྟོག-མེད	mental cognition without concepts
ཡིན-ཡོད-དུ-སྒྲུབ-པ	establishing identity as being present
ཡུལ	 four types of objects|Location, as one of the ten non-concurrent formations 
ཡུལ-གྱི-ཁམས-ལྔ	five elements of the sense objects, as of the eighteen elements
ཡུལ-ཅན	perceiver-subject
ཡུལ-དུས-རྣམ-པ	place, time and kind
ཡུལ-ཡུལ-ཅན	subject and object
ཡོངས-གཅོད-དུ-གྲུབ-པ	exclusively established
གཡོ	Hypocrisy, as one of the twenty subsidiary disturbances
རང-གར-གནས-པ	self-sufficient abiding
རང-རྒྱལ-བསེ-རུ-ལྟ-བུ	rhinoceros-like pratyekabuddhas
རང-རྒྱུད-ཀྱི-ཚོར-བས-ཟིན-པའི-ཁམས	nine elements embraced by personal sensation
རང-མཚན	individual characteristic
རང-མཚན-པ	intrinsically existent
རང-རིག-པ	individually self-cognizant
རང-རིག-པས-ཉམས-སུ-མྱོང-བའི-ཐ-སྙད	designation being made from experiencing with self-cognizance
རི-བོང-གི-རྡུལ	rabbit particle
རིལ-པོ	whole
རིས-མཐུན-པ	similar class, as one of the fourteen non-concurrent formations
རེག-པ	 contact, as one of the twelve links|Contact, as one of the five ever-present mental states 
རེག-བྱ	Textures
རེག-བྱའི-ཁམས	element of textures, as one of the eighteen elements
རོ	Tastes
རླུང-ཁམས	wind element
ལམ-བདེན	 true paths|truth of path, as interdependent links 
ལས-ཀྱི-ཀུན-ནས-ཉོན-མོངས-པ	Affliction of karma
ལས-ཀྱི-གཞན-དབང	dependency of karma
ལས-འདུ-བྱེད-པ	formations of karma
ལུག-གི-རྡུལ	sheep particle
ལུགས-འབྱུང-གི-རྟེན-འབྲེལ	interdependent links in progressive order
ལུང-མ-བསྟན	undetermined
ལུས-ཀྱི-ཁམས	body element, as one of the eighteen elements
ལུས-རྒྱས-པའི-རྒྱུ-བཞི	four causes for bodily development
ལུས-ཚོར	physical sensations
ལུས-ལ-སྲེད-པ	physical craving
ལེ-ལོ	Laziness, as one of the twenty subsidiary disturbances
ལེན-པ	grasping, as one of the twelve links
ལོག-རྟོག	Misunderstanding, as one of four types of cognition
ལོག-པར-ལྟ-བ	Perverted belief, as one of the five beliefs
ལོག-འཚོ	perverted livelihood
ཤིན-ཏུ-སྦྱང-བ	Pliancy, as one of the eleven virtuous mental states
ཤེས-བརྗོད-འཇུག-གསུམ	cognizing, describing or engaging
ཤེས-པ	mind
ཤེས-བྱ	 knowable things| objects of knowledge |knowables 
ཤེས-བྱ-ཐམས-ཅད-ཀྱི-ཡུལ-ཅན	perceiver-subject of all knowable things
ཤེས-བྱ-གཞི-ལྔ	fivefold basis of knowables
ཤེས-བྱེད	cognitive acts
ཤེས-བཞིན	Alertness
ཤེས-བཞིན-མིན-པ	Inattention, as one of the twenty subsidiary disturbances, alt: (non-alertness)
ཤེས-བཞིན-མེད-པ	Non-alertness, as one of the 20 subsidiary disturbances
ཤེས-རབ	Discrimination, as one of the five object determining mental states
ཤེས-རབ-ཉོན-མོངས-ཅན	disturbed discrimination
སངས-རྒྱས-ཆོས-ཀྱི-སྐུ	dharmakaya of buddhahood
སའི-ཁམས	earth element
སེམས	cognitive acts
སེམས-ཀྱི-ས-མང-བཅུ	ten general mind bases
སེམས-ཁམས-བདུན	seven mental elements
སེམས-ཁེགས-པའི-གནས-སྐབས	occasion of blocked cognition
སེམས-ཅན-དུ-སྟོན-པ-དོན-རྗོད-པར-བྱེད-པའི-སྒྲ	Animate sounds expressing a meaning
སེམས-དང-མཚུངས-ལྡན-གྱི-འདུ-བྱེད	 formations concurrent with mind|formations concurrent with mind 
སེམས-དང-མཚུངས-པར-ལྡན-པ-མིན-པའི-འདུ-བྱེད	formations not concurrent with mind
སེམས-པ	 Attraction, as one of the five ever-present mental states|Apprehension 
སེམས-བྱུང	mental states
སེམས-བྱུང-ཀུན-འགྲོ-ལྔ	five ever-present mental states
སེམས-བྱུང-ལྔ-བཅུ-ང-གཅིག	fifty-one mental states
སེམས-བྱུང-ཡུལ-ངེས-བྱེད-ལྔ	five object determining mental states
སེམས-ཙམ	Mind Only
སེམས-ཚོར	mental sensations
སེམས-ཡིད-རྣམ-ཤེས-གསུམ	cognitive act, mental faculty and consciousness
སེམས-གཡེང-བ	distraction
སེར-སྣ	Stinginess, as one of the twenty subsidiary disturbances
སེལ-བ	exclusion
སེལ-བས-འཇུག-པ	perception through exclusion
སོ-སོའི-སྐྱེ-བོ	Ordinary person, as one of the ten non-concurrent formations
སོ-སོར-ངེས-པ	Definitive distinctiveness, as one of the ten non-concurrent formations
སོ-སོར-བརྟགས-པ	discrimination
སོ-སོར-བརྟགས-པའི-ཤེས-རབ	discriminating knowledge
སོ-སོར-བརྟགས-པས-འགོག-པ	cessation due to discrimination, as one of the seven elements of mental objects
སོ-སོར-བརྟགས-མིན-གྱིས-འགོག-པ	cessation not due to discrimination, as one of the seven elements of mental objects
སྲིད-པ	 existence|becoming, as one of the twelve links 
སྲིད-པའི-འདོད-ཆགས	Attachment of existence
སྲིད-རྩེ	summit of existence
སྲིད-རྩེ-ལ-སྙོམས-པར-ཞུགས-པའི-འདུ-ཤེས	perception of the serenity at the summit of existence
སྲིད-རྩེའི-སེམས	state of mind of the summit of existence
སྲེད-པ	craving, as one of the twelve links
སྲེད-པ-གསུམ	three cravings
སྲོག-གི-དབང-པོ	life faculty, as one of the fourteen non-concurrent formations
གསལ-བའི-གཟུགས	clear forms
གསལ-རིག	cognizant and conscious
བསམ-གཏན	dhyana
བསམ-གཏན-དང-པོ	first dhyana
བསོད-ནམས-དགེ-བའི-ལས	meritorious actions of virtue
བསོད-ནམས-མིན-པ-མི-དགེ-བའི-ལས	non-meritorious actions of nonvirtue
ལྷན-སྐྱེས-དང-ཀུན-བཏགས	innate and imputed
ལྷན-ཅིག-བྱེད-པའི-རྐྱེན	co-operating conditions
ལྷན-ཅིག-མི-གནས-འགལ	Non-coexistent opposition
ལྷའི-རྣ-བ	divine ear
ལྷའི-མིག	divine eye
