དཀོན-མཆོག-གསུམ	Three Jewels, Precious Ones\nSanskrit: trīṇi ratnāni\nPali: tīni ratanāni
སངས-རྒྱས	Buddha, The Clear and Evolved One, The Awakenend One\nSanskrit: buddhaḥ\nPali: buddho
ཆོས	Teaching, reality, truth, law, cosmic order; phenomenon\nSanskrit: dharmaḥ\nPali: dhammo
དགེ-འདུན	Noble community, intent community\nSanskrit: saṅghaḥ\nPali: saṅgho
འཕགས-པའི-བདེན-པ-བཞི	Four Noble Truths, Four Holy Truths\nSanskrit: catvāri ārya-satyāni\nPali: cattāri ariya-saccāni
སྡུག-བསྔལ	Suffering, dissatisfaction\nSanskrit: duḥkham\nPali: dukkham
ཀུན-འབྱུང	Source (of Suffering)\nSanskrit: samudayaḥ\nPali: samudayo
འགོག-པ	Dissolution, End (of Suffering)\nSanskrit: nirodhaḥ\nPali: nirodho
ལམ-རྣམས	Way, path\nSanskrit: mārgaḥ\nPali: maggo
ཆོས-ཀྱི-ཕྱག-རྒྱ-བཞི	Four Seals, Four basic marks of the teachings.\nSanskrit: catvāri dharmapadāni\nPali: cattāri dhamma-padāni
འདུ-བྱེད-ཐམས-ཅད-མི-རྟག-པ	Impermanent are all formative powers\nSanskrit: anityāḥ sarva-saṃskārāḥ\nPali: aniccā sabbe saṅkhārā
འདུ-བྱེད-ཐམས-ཅད-སྡུག-བསྔལ-བ	Suffering are all formative powers\nSanskrit: duḥkhāḥ sarva-saṃskārāḥ\nPali: dukkhā sabbe saṅkhārā
ཆོས-ཐམས-ཅད-བདག-མེད-པ	Without (independent) self are all phenomena\nSanskrit: nirātmānaḥ sarva-dharmāḥ\nPali: anattā sabbe dhammā
མྱ-ངན-ལས-འདས-པ	Nirvana is peace\nSanskrit: śāntaṃ nirvāṇam\nPali: santaṃ nibbāṇam
ཕུང-པོ-ལྔ	Five heaps, components of being, skandhas\nSanskrit: paсca skandhāḥ\nPali: paсca khandhā
གཟུགས	Form, materiality, physical form\nSanskrit: rūpam\nPali: rūpam
ཚོར-བ	 feeling\nSanskrit: vedanā\nPali: vedanā|Feeling, basic feeling\nSanskrit: vedanā\nPali: vedanā 
འདུ-ཤེས	perception, discrimination, categorization\nSanskrit: saṃjсā\nPali: saссā
འདུ-བྱེད	formative power, volition, karmic formation\nSanskrit: saṃskāraḥ\nPali: saṅkhāro
རྣམ-ཤེས	 consciousness\nSanskrit: vijсānam\nPali: viссānam|consciousness\nSanskrit: vijсānam\nPali: viссānam 
གཟུགས-ཕུང-བཅུ-གཅིག	eleven components of physical form\nSanskrit: ekādaśa rūpaskandhāḥ\nPali: ekādasa rūpakhandhā
རྣམ-པར-རིག-བྱེད-ཕས	physical expression\nSanskrit: vijсaptiḥ\nPali: viссatti
རཆོར-པ-གསུམ-༼བདེ-པ།-སྔུག-པ།-སྔུག-མིན-བདེ-མིན-༽	pleaseant, unpleasant, neither pleasant nor unpleasant feeling.\nSanskrit: vedanā trividhā (sukhā, duḥkhā, aduḥkhā-asukhā ca)\nPali: vedanā tividhā (sukhā, dukkhā, adukkhā asukhā ca)
འདུ-ཤེས-ཀྱི-ཕུང-པོ-དུ-ཤེས-ཚད-མ-ཉི-པར-འཛིན-པའི-བདག-ཉིད	component of perception: perception is by nature grasping at or taking an image.\nSanskrit: saṃjсā-skandha: saṃjсā nimitta-udgrahaṇa-ātmikā\nPali: saссā-khandho: saссā nimitta-uggahaṇa-attikā
འདུ-བྱེད-རྣམ-པ-གཉིས	the formative powers are twofold\nSanskrit: saṃskārā dvividhā\nPali: saṅkhārā dvividhā
སེམས-དང-མཚུངས-པར-ལྡན-པའི-འདུན-བྱེད	formative powers connected with mind (40, e.g. feeling, sensation, will, happiness, anger)\nSanskrit: citta-samprayukta-saṃskārāḥ\nPali: citta-saṃpayutta- saṅkhārā
སེམས-དང-མཚུངས-པར-ལྡན-པ-མ-ཡིན-པའི-འདུན-བྱེད	 formative powers not connected with mind\nSanskrit: citta-viprayukta-saṃskārāḥ\nPali: citta-vipayutta- saṅkhārā
ཁམས-བཅོ-བརྒྱད	eighteen elements\nSanskrit: aṣṭādaśa dhātavaḥ\nPali: aṭṭhādasa dhātavo
མིག།-རྣ-བ།-སྣ།-ལྕེ།-ལུས།-ཡིད	Eye, ear, nose, tongue, body, thinking or mind\nSanskrit: cakṣu , śrotraḥ , ghrāṇam , jihvā , kāyaḥ , manas\nPali: cakkhu, soto, ghānam, jivhā, kāyo, mano
གཟུགས།-སྒྲ།-དྲི།-རོ།-རེག-བྱ།-ཆོས	Form, sound, smell, taste, touch, thing or phenomenon (dharma)\nSanskrit: rūpam , śabdaḥ , gandhaḥ , rasaḥ , sparśaḥ , dharmaḥ\nPali: rūpam, saddo, gandho, raso, phasso, dhammo
མིག-གི-རྣམ-པར-ཤེས-པ།-རྣ-བའི-ར།-སྣའི-ར།-ལྕེའི-ར།-ལུས-ཀྱི-ར།-ཡིད-ཀྱི-ར	consciousness of seeing, hearing, smelling, tasting, touching, thinking\nSanskrit: cakṣu-vijсānam , śrotra-v., ghrāṇa-v, jihvā-v., kāya-v., mano-v.\nPali: cakkhu-viссānam, sota-v., ghāna-v, jivhā-v, kāya-v, mano-v
འབྱུང-ན-ཆེན-པོ	five great elements\nSanskrit: paсca mahābhūtāni\nPali: paсca mahābhūtāni
ས།-ཆུ།-མེ།-རླུང།-ནམ-མཁའ	earth, water, fire, wind, space\nSanskrit: pṛthvī , ap (f, Nom pl. āpas), tejas , vāyu , ākāśaḥ\nPali: paṭhavī, āpo, tejo, vāyo , ākāso
འདུས-མ-བྱས-གསུམ	three uncreated (phenomena)\nSanskrit: trīṇi asaṃskṛtāni\nPali: tīni asaṅkhatāni
ནམ-ཁའ།-སོ-སོར-བརྟགས-པའི-འགོག-པ།-སོ-སོར-བརྟགས-མིན-གྱི-འགོག-པ	Space, dissolution or cessation connected with thinking, dissolution or cessation not connected with thinking (the last two terms are used for nirvana)\nSanskrit: ākāśaḥ , pratisaṅkhyā-nirodhaḥ , pratisaṅkhyā-nirodhaḥ\nPali: ākāso, paṭisaṅkhā-nirodho, apaṭisaṅkhā-nirodho
རྟེན-འབྲེལ-ཡན-ལག-བཅུ-གཉིས	Dependent arising with twelf links\nSanskrit: dvādaśāṅga-pratītya-samutpādaḥ\nPali: dvādasaṅga-paṭicca-samuppāda
མ-རིག-པ	 ignorance, not knowing\nSanskrit: avidyā\nPali: avijjā|ignorance, basic ingorance, not knowing, unknowing\nSanskrit: avidyā\nPali: avijjā 
འདུ-བྱེད-རྣམས	formative powers\nSanskrit: saṃskārāḥ\nPali: saṅkhārā
མིང-གཟུགས	name and form\nSanskrit: nāma-rūpam\nPali: nāma-rūpam
སྐྱེ-མཆེད-དྲུག	sixfold field (of perception).\nSanskrit: ṣaḍ-āyatanam\nPali: saḷ-āyatanam
རེག-པ	contact (between sense-organ and sense-object).\nSanskrit: sparśaḥ\nPali: phasso
སྲེད-པ	thirst, craving\nSanskrit: tṛṣṇā\nPali: taṇhā
ལེན-པ	grasping\nSanskrit: upādānam\nPali: upādānam
སྲིད-པ	Becoming.\nSanskrit: bhavaḥ\nPali: bhavo
སྐྱེ-བ	birth.\nSanskrit: jātiḥ\nPali: jāti
རྒ-ཤི-ངན-སྨི-ངག-འདོན-པ-སྡུག-བསྔལ-བ-ཡིན-མི-བདེ-བ-འཁྲུག-པ	Aging and dying, sorrow, complaint, suffering, grief, despair\nSanskrit: jarā-maraṇam , śoka-parideva-duḥkha-daurmanasya-upāyāsaḥ\nPali: jarā-maraṇam, soka-parideva-dukkha-domanassa-upāyāso
འགྲོ-བ-དྲུག	six realms (of rebirth)\nSanskrit: ṣaḍ-gatayaḥ (f. sg. gati)\nPali: cha gatī
དམྱལ-བ	denizen of hell, hellbeing\nSanskrit: narakaḥ\nPali: narako
ཡི-དནགས	animal\nSanskrit: tiryaсc\nPali: tiracchānam
དུད-འགྲོ	hungry ghost\nSanskrit: pretaḥ\nPali: peto
ལྷ-མ-ཡིན	demigod, titan, jealous god\nSanskrit: asuraḥ\nPali: asuro
མི	human\nSanskrit: manuṣyaḥ\nPali: manusso
ལྷ	god, deva\nSanskrit: devaḥ\nPali: devo
བདུད-བཞི	four maras.\nSanskrit: catvāro mārāḥ\nPali: cattāro mārā
ཕུང-པོའི-བདུད	mara of the components of existence\nSanskrit: skandha-māraḥ\nPali: khandha-māro
ཉོན-མོངས-པའི-བདུད	mara of defilements\nSanskrit: kleśa-māraḥ\nPali: kilesa-māro
ལྷའི-བུའི-བདོད	demigod-mara\nSanskrit: deva-putra-māraḥ\nPali: deva-putta-māro
འཆི-བདག-གི-བདུད	mara of death\nSanskrit: mṛtyu-māraḥ\nPali: maccu-māro
བྱུང-ཆུབ-ཕྱོགས-མཐུན-གྱི-ཆོས-སུམ-ཅུ-རྩ-བདུན	37 factors of awakening\nSanskrit: sapta-triṃśad bodhipākṣikā dharmāḥ\nPali: satta-tiṃsa bodhipakkhikā dhammā
དྲན-པ-ཉེར-བཞག-བཞི	four foundations of mindfulness\nSanskrit: catvāri smṛty-upasthānāni\nPali: cattāri sati-paṭṭhānāni
ལུས-ལ-ལུས-རྗེས-སུ-ལྟ-བའི-དྲན-པ-ཉི-བར-བཞག-པ	With the body: mindfulness of the body\nSanskrit: kāye kāyānudarśa-smṛty-upasthānam\nPali: kāye kāyanupassana-sati-paṭṭhānam
རྩཧོར-བ-ལ-ཚོར-བ-རྗེས-སུ-ལྟ-བའི-དྲན-པ-ཉི-བར-བཞག-པ	With feelings: mindfulness of feelings\nSanskrit: vedanāsu vedanānudarśa-smṛty-upasthānam\nPali: vedanāsu vedananupassana-sati-paṭṭhānam
སེམས-ལ-སེམས-རྗེས-སུ-ལྟ-བའི-དྲན-པ-ཉི-བར-བཞག-པ	With the mind: mindfulness of the mind\nSanskrit: citte cittānudarśa-smṛty-upasthānam\nPali: citte cittanupassana-sati-paṭṭhānam
ཆོས-ལ-ཆོས-རྗེས-སུ-ལྟ-བའི-དྲན-པ-ཉི-བར-བཞག-པ	With phenomena: mindfulness of phenomena\nSanskrit: dharmeṣu dharmānudarśa-smṛty-upasthānam\nPali: dhammesu dhammanupassana-sati-paṭṭhānam
ཡང-དག-སྤོང-བ-བཞི	four right efforts, four noble efforts.\nSanskrit: catvāri samyak-prahāṇāni\nPali: cattāri sammā-padhānāni
དགེ-བའི-རྩ-བ-སྐྱེས-པ-རྣམས-ཡང-དག-པར-བསྲུང-བ	Guarding the roots of the wholesome which has arisen.\nSanskrit: utpannānāṃ kuśala-mūlānāṃ saṃrakṣaṇam\nPali: uppannānāṃ kusala-mūlānāṃ saṃrakkhaṇam
དགེ-བའི-རྩ-བ-མ-སྐྱེས-པ-རྣམས-ཡང-དག-པར-སྐྱེད-པ	Unfolding the roots of the wholesome which has not yet arisen.\nSanskrit: anutpannānāṃ kuśala-mūlānāṃ samutpādam\nPali: anuppannānāṃ kusala-mūlānāṃ samuppādam
མི-དགེ-བའི-ཆོས-སྐེས-པ-རྣམས-སྤོང-བ	Overcoming the unwholesome which has arisen.\nSanskrit: utpannānāṃ akuśalānāṃ dharmāṇāṃ prahāṇam\nPali: uppannānāṃ akusalānāṃ dhammānāṃ pahāṇam
མི-དགེ-བའི-ཆོས-མ-སྐྱེས-པ-རྣམས-མི-སྐྱེད-པར-བྱེད-པ	Not unfolding the unwholesome which has not yet arisen.\nSanskrit: anutpannānāṃ akuśalānāṃ dharmāṇāṃ anutpādaḥ\nPali: anuppannānāṃ akusalānāṃ dhammānāṃ anuppādo
རྫུ-འཕྲུལ-གྱི-རྐང-པ-བཞི	four paths to power\nSanskrit: catvāri ṛddhi-pādāḥ\nPali: cattāri iddhi-pādā
འདུན-པའི-ཏིང-ངེ-འརྫིན-སྤོང-བའི-འདུ-བྱེད-དང-ལྡན-པའི-རྫུ-འཕྲུལ-གྱི-རྐང-པ	Path to power endowed with the energy of effort for concentration of will.\nSanskrit: chanda-samādhi-prahāṇāya-saṃskāra-samanvāgata-ṛddhi-pādaḥ\nPali: chanda-samādhi-padhāna-saṃkhāra-samannāgato iddhi-pādo
དེ-བཞིན-དུ-སེམས-པའི-རྫུ-འཕྲུལ-གྱི-རྐང-པ	Path to power (endowed with the energy of effort for concentration) of mind.\nSanskrit: evaṃ citta-ṛddhi-pādaḥ\nPali: evaṃ citta-iddhi-pādo
བརྩོན-འགྲུས-ཀྱི-རྫུ-འཕྲུལ-གྱི-རྐང-པ	path to power of energy\nSanskrit: vīrya-ṛddhi-pādaḥ\nPali: evaṃ viriya-iddhi-pādo
དཔྱོད-པའི-ཏིང-ངེ-འརྫིན-སྤོང-བའི-འདུ-བྱེད-དང-ལྡན-པའི-རྫུ-འཕྲུལ-གྱི-རྐང-པ	Path to power endowed with the energy of effort for concentration of reasoning.\nSanskrit: mīmāṃsā-samādhi-prahāṇāya-saṃskāra-samanvāgata-ṛddhi-pādaḥ\nPali: vīmaṃsā-samādhi-padhāṇāya-saṃskāra-samanvāgato iddhi-pādo
དབང-པོ-ལྔ	five faculties\nSanskrit: paсca-indriyāṇi , paсca balāni\nPali: paсca-indriyāni, paсca balāni
དད-པ།-ཏིང-ངེ-འཛིན།-བརྩོན-འགྲུས།-དྲན-པ།-ཤེས-རབ	confidence or faith, concentration or absorpotion, energy, mindfulness, understanding or wisdom\nSanskrit: śraddhā , samādhi , vīryam , smṛtir , prajсā\nPali: saddhā, samādhi, viriya, sati, paссā
བྱང-ཆུབ-ཡན-ལག-འདུན	seven factors or limbs of enlightenment\nSanskrit: sapta bodhy-aṅgāni\nPali: satta bojjhaṅgāni
དྲན-པ	awareness, mindfulness.\nSanskrit: smṛtiḥ\nPali: sati
ཆོས-རབ-ཏུ-རྣམ-པར-འབྱེད-པ	discriminating phenomena.\nSanskrit: dharma-vicayaḥ\nPali: dhamma-pavicayo
བརྩོན-འགྲུས	energy, perseverance, effort.\nSanskrit: vīryam\nPali: viriyam
དགའ-བ	joy\nSanskrit: prītiḥ\nPali: pīti
ཤིན-སྦྱངས	stilled mind\nSanskrit: prasrabdhiḥ\nPali: passaddhi
དིང-ངེ-འཛིན	concentration, absorption\nSanskrit: samādhi\nPali: samādhi
བཏང-སྙོམས	 equanimity, balanced acceptance\nSanskrit: upekṣā\nPali: upekkhā|equanimity, balanced acceptance\nSanskrit: upekṣā\nPali: upekkhā 
འཕགས-ལམ-ཡན-ལག-བརྒྱད	The noble eigthfold path\nSanskrit: āryāṣṭāṅgika-mārgaḥ\nPali: ariya-aṭṭhaṅgika-maggo
ཡང-དག-བའི-ལྟ-བ	right view, correct view, worldview\nSanskrit: samyag-dṛṣṭiḥ\nPali: sammā-diṭṭhi
ཡང-དག-བའི-རྟོག-པ	rigth intention\nSanskrit: samyak-saṃkalpaḥ\nPali: sammā-saṅkappo
ཡང-དག-བའི-ངག	right speech\nSanskrit: samyag-vāk\nPali: sammā-vācā
ཡང-དག-བའི-ལས-ཀྱི-མཐ	right action\nSanskrit: samyak-kārmāntaḥ\nPali: sammā-kammanto
ཡང-དག-བའི-འཚོ-བ	right livlihood, right way to earn ones livlihood.\nSanskrit: samyag-ājīvaḥ\nPali: sammā-ājīvo
ཡང-དག-བའི-རྩཧོལ-བ	right effort\nSanskrit: samyag-vyāyāmaḥ\nPali: sammā-vāyāmo
ཡང-དག-བའི-དྲན-པ	right awareness, mindfulness\nSanskrit: samyag-smṛtiḥ\nPali: sammā-sati
ཡང-དག-བའི-ཏིང-ངེའཛིན	right absorption, meditative absorption;Meditation and practice\nSanskrit: samyak-samādhi\nPali: sammā-samādhi
བསམ-གཏན-བཞི	four meditative absorptions.\nSanskrit: catvāri dhyānāni\nPali: cattāri jhānāni
རྟོག-པ-དང-བཅས-ཤིང-དཔྱོད-པ-དང-བཅས-པ-དབེན-པ-ལས-སྐྱེས-པའི-དགའ-བ-དང-བདེ-བ-ཅན-བསམ-གཏན-དང-པོའོ	Connected with mental contacting and thinking, arisen from retreating, joyful and happy – this is the first absorption\nSanskrit: savitarkaṃ savicāraṃ vivekajaṃ prīti-sukham iti prathamaṃ dhyānam\nPali: savitakkaṃ savicāraṃ vivekajaṃ pīti-sukham iti paṭhamaṃ jhānam
ནང-རབ-ཏུ-དགའ-བ-དང-བདེ-བ-ཅན-ནི-གཉིས-པའོ	From inner well-being joyful and happy – this is the second absorption.\nSanskrit: adhyātma-pramodanāt prīti-sukham iti dvitīyaṃ dhyānam\nPali: ajjhatta-pamodanā pīti-sukham iti dutiyaṃ jhānam
བདེ-མིན-སྡུག-མིན-གྱི-ཚོར-བ-བདང-སྙོམས-དང-དྲན-པ-ཡོངས-སུ-དག-པ-བསམ-གཏན-བཞི-པའོ	Connected with equanimity, mindfulness and complete purity, neither unpleasant nor pleasant feeling – this is the fourth absorption.\nSanskrit: upekṣā-smṛti-pariśuddhir aduḥkhāsukkhā vedaneti caturthaṃ dhyānam\nPali: upekkhā-sati-parisuddhim adukkhāsukhā vedanā iti catutthaṃ jhānam
ཚངས-པའི-གནས-བཞི	four divine abodes, four divine emotions\nSanskrit: catvāri brahma-vihārāḥ\nPali: catvāri brahma-vihārā
བྱམས-པ	friendliness, friendship, love\nSanskrit: maitrī\nPali: mettā
སྙིང-རྗེ	compassion\nSanskrit: karuṇā\nPali: karuṇā
དགའ-པ	sympathetic joy\nSanskrit: muditā\nPali: muditā
བྱམས-པ-ཆེན-པོ-རྣམ-པ-གསུམ	unlimited friendliness is threefold\nSanskrit: mahā-maitrī trividhā\nPali: mahā-mettā tividhā
བདེན-པ-ལ-དམིགས-པ།-ཆོས-ལ-དམིགས-པ།-དམིགས-པ-མེད-པ	relying on the truth (of what is), relying on the (buddhist) teachings, not relying on something, without reference-point\nSanskrit: satyālambanā, dharmālambanā, an-ālambanā\nPali: saccālambanā, dhammālambanā, an-ālambanā
བླ-ན-མེད-པའི-མཆོད-པ-རྣམ-པ-བདུན	the sevenfold highest worship (of a buddha or a deity), sevenfold puja\nSanskrit: saptavidhā anuttarapujā
ཕྱག-འཚལ-བ	praising\nSanskrit: vandanā
མཆོད-པ	worshipping, showing respect\nSanskrit: pūjanā
སྡིག-པ-བཤགས-པ	confession of evil\nSanskrit: pāpa-deśanā
རྗེས-སུ-ཡི-རངས-པ	rejoicing in the wholesome\nSanskrit: puṇya-anumodanā
བསྐུལ-པ	requesting to beg; pray\nSanskrit: adhyeṣaṇā
བྱང-ཆུབ-ཏུ-སེམས-བསྐྱེད-པ	 developing the mind aimed at enlightenment\nSanskrit: bodhicitta-utpādaḥ\nPali: bodhicitt' uppāda|developing the mind aimed at enlightenment\nSanskrit: bodhicitta-utpādaḥ 
བསྔོ-བ	dedication\nSanskrit: pariṇāmanā
བསྡུ-པའི-དངོས-པོ-བཞི	four kinds of affection (by bodhisattvas)\nSanskrit: catvāri saṅgraha-vastūni\nPali: catvāri saṅgaha-vatthūni
སྦྱིན-པ	giving, generosity\nSanskrit: dānam\nPali: dānam
སྙན-པར-སྨྲ	loving speech\nSanskrit: priyavacanam\nPali: peyya-vajjam
དོན-སྤྱད-པ	behaviour which is useful (for others)\nSanskrit: artha-caryā\nPali: attha-cariyā
དོན-མཐུན-པ	equalness (in goal and experience)\nSanskrit: samānārthatā\nPali: samānattatā
དགེ-བའི-རྩ-བ-གསུམ	three roots of wholesome (der Bodhisattvas)\nSanskrit: trīṇi kuśala-mūlāni\nPali: tīni kusala-mūlāni
ལྷག-བསམ-རྣམ-པར-དག-པ	purification of intention or inclination\nSanskrit: āśaya-viśuddhiḥ\nPali: āsaya-visuddhi
ང-དང-ང-ཡི-བའི-རྣམ-པ-ཡོངས-སུ-སྤངས-པ	completely giving (up the tendency for) *me* and *mine*\nSanskrit: ahaṅkāra-mamakāra-parityāgaḥ\nPali: ahaṅkāra-mamaṃkāra-pariccāga
དགེ-པའི-རྩ-བ-གསུམ	three roots of wholesome\nSanskrit: trīṇi kuśala-mūlāni\nPali: tīni kusala-mūlāni
ཞི-སྡང-མེད-པ	non-hatred, absence of hatred\nSanskrit: a-dveṣaḥ\nPali: a-doso
འདོད-ཆགས-མེད-པ	non-attachment, absence of attachment\nSanskrit: a-lobhaḥ\nPali: a-lobho
གཏི-མུག-མེད-པ	Non-confusion, absence of confusion or bewilderment\nSanskrit: a-mohaḥ\nPali: a-moho
མི-དགེ-པའི-རྩ-བ-གསུམ	three roots of the unwholesome\nSanskrit: trīṇi akuśala-mūlāni\nPali: tīni akusala-mūlāni
འདོད-ཆགས	 greed, wanting\nSanskrit: rāgaḥ\nPali: rāgo|attachment\nSanskrit: lobhaḥ\nPali: lobho 
ཞི-སྡང	hatred\nSanskrit: dveṣaḥ\nPali: doso
གཏི-མུག	confusion. bewilderment\nSanskrit: mohaḥ\nPali: moho
མི-དགེ-བ-བཅུ	ten unwholesome (actions).\nSanskrit: daśa-akuśalāni\nPali: dasa-akusalāni
སྲོག-གཅོད-པ	killing (lit., taking the breath)\nSanskrit: prāṇa-atipātaḥ\nPali: pāṇa-atipāto
མ-བྱིན-པ-ལེན-པ	taking what is not given.\nSanskrit: adatta-ādānam\nPali: adatta-ādānam
འདོད-པ-ལ-ཨོག-པར-གཡེམ-པ	improper or wrong sexual conduct.\nSanskrit: kāma-mithyā-ācāraḥ\nPali: kāma-micchā-ācāro
བཇུན-སྨྲ-བ	false speech, telling lies.\nSanskrit: mṛṣā-vādaḥ\nPali: musā-vādo
ཕྲ-མ	harsh speech\nSanskrit: paiśunyam\nPali: pesuniya, pesuссam
ཚིག-རྩུབ	gross speech, divisive talk.\nSanskrit: pāruṣyam\nPali: phārussam
ངག-བཀྱལ	senseless talk, idle gossip\nSanskrit: saṃbhinna-pralāpaḥ\nPali: saṃbhinna-palāpo
བརྣབ-སེམས	covetousness\nSanskrit: abhidhyā\nPali: abhijjhā
གནོད-སེམས	ill will. Wanting to harm others.\nSanskrit: vyāpādaḥ\nPali: vyāpādo
ལོག-པར-ལྟ-བ	 View which relys on wrong ideas\nSanskrit: mithyā-dṛṣṭiḥ\nPali: micchā-diṭṭhi|wrong view.\nSanskrit: mithyā-dṛṣṭiḥ\nPali: micchā-diṭṭhi 
ཉོན-མོངས-པ-དྲུག	six main defilements, six root delusions.\nSanskrit: ṣaṭ kleśāḥ\nPali: cha kilesa
ཁོང-ཁྲོ	hatred, aversion, rejection (lit. beating against)\nSanskrit: pratighaḥ\nPali: paṭigho
ང-རྒྱལ	 conceit, inflation, arrogance\nSanskrit: mānam\nPali: mānam|conceit, arrogance, inflation\nSanskrit: mānam\nPali: mānam 
ཨོག-ལྟ	wrong view, false view.\nSanskrit: kudṛṣṭiḥ\nPali: kudiṭṭhi
ཐེ-ཚོམ	wrong doubt, indecisive wavering\nSanskrit: vicikitsā\nPali: vicikicchā
ལྟ-བ-ལྔ	five harmful views, or false, useless views.\nSanskrit: paсca dṛṣṭayaḥ\nPali: paсca diṭṭhī
འཇིག-ཚོགས-ལ-ལྟ-བ	belief in permanent identity (lit. view of the body as permanent entity)\nSanskrit: sat-kāya-dṛṣṭiḥ\nPali: sakkāya-diṭṭhi
མཐར-འཛིན-གྱི-ལྟ-བ	View which clings to extreme views.\nSanskrit: anta-grāha-dṛṣṭiḥ\nPali: anta-ggāhikā-diṭṭhi
ལྟ-བ-མཆོག-ཏུ-འཛིན-པ	clinging to views\nSanskrit: dṛṣṭi-parāmārśaḥ\nPali: diṭṭhi-parāmaso
ཚུལ-ཁྲིམས-དང-བརྟུལ-ཞུགས-མཆོག-འཛིན	clinging to discipline and vows.\nSanskrit: śīla-vrata- parāmārśaḥ\nPali: sīla-vvata-parāmaso
ཉེ-ཉོན-ཉེར-བཞི	twenty-four secondary defilements.\nSanskrit: catur-viṃśatir upakleśāḥ\nPali: cattāro vīsati upakkilesā
ཁོན-ཁྲོ	1. anger, belligerence\nSanskrit: krodhaḥ\nPali: kodho
འཁོན-འཛིན	harmfulness; resentment\nSanskrit: upanāhaḥ\nPali: upanāho
འཆབ-པ	ill will\nSanskrit: mrakṣaḥ\nPali: makkho
འཚིག-པ	spite\nSanskrit: pradāśaḥ\nPali: paḷāso
ཕྲག-དོག	jealousy; envy\nSanskrit: īrṣyā\nPali: issā
སེར-སྣ	Avarice\nSanskrit: mātsaryam\nPali: macchariyam
གཡོ	lying in ambush\nSanskrit: śāṭhyam\nPali: sāṭheyyam
སྒྱུ	deceit\nSanskrit: māyā\nPali: māyā
རྒྱགས-པ	inflation, arrogance\nSanskrit: madaḥ\nPali: mado
རྣམ-འཚེ	cruelty, harmfulness\nSanskrit: vihiṃsā\nPali: vihiṃsā
ངོ-ཚ-མེད-པ	lack of shame, shamlesness, lack of embarassment (i.e. no concern for self)\nSanskrit: ahrīḥ\nPali: ahirikam
ཁྲེལ-མེད	inconscientiousness,inconsideration, ruthlessness (i.e. no concern for others)\nSanskrit: an-apa-trāpyam\nPali: anottappam
རྨུགས-པ	ridgidity, lethargy\nSanskrit: styānam\nPali: thīnam
རྒོད-པ	 excitement\nSanskrit: auddhatyam\nPali: uddhaccam|lack of seriousness\nSanskrit: auddhatyam\nPali: uddhaccam 
མ-དད-པ	lack of faith\nSanskrit: aśrāddhyam\nPali: assaddhiyam
ལེ-ལོ	 carelessness, laziness, sluggishness, laxity\nSanskrit: kausīdyam\nPali: kosajjam|Sluggishness, sloth, lethargy\nSanskrit: kausīdyam\nPali: kosajjam 
བད-མེད	lack of concideration, of interest\nSanskrit: pramādaḥ\nPali: pamādo
བརྗེད-ངེས	forgetfulness\nSanskrit: muṣita-smṛtiḥ\nPali: musita-ssati
རྣན-གཡེང	confusion\nSanskrit: vikṣepaḥ\nPali: vikkhepo
ཤེས-བཛིན-མ-ཡིན-པ	non-introspection\nSanskrit: a-sam-prajanyam\nPali: a-sam-pajaссam
འགྱོད-པ	regret\nSanskrit: kaukṛtyam\nPali: kukuccam
གཉིད	sleepiness\nSanskrit: middham\nPali: middham
རྟོག-པ	thinking\nSanskrit: vitarkaḥ\nPali: vitakko
དཔྱོད-པ	Analysing.  Restlessness due to regret, sleepiness, moving towards thoughts, intensely thinking about something.\nSanskrit: vicāraḥ\nPali: vicāro
འཇིགས-པ-ལྔ	five kinds of fear\nSanskrit: paсca bhayāni\nPali: paсca bhayāni
འཚོ-བའི-འཇིགས-པ	fear about earning one's living\nSanskrit: ājīvikā-bhayam\nPali: ājīvikā-bhayam
མྱ-ངན-གྱི-འཇིགས-པ	fear of sorrow\nSanskrit: śoka-bhayam\nPali: soka-bhayam
འཆི-བའི-འཇིགས-པ	fear of death\nSanskrit: maraṇa-bhayam\nPali: maraṇa-bhayam
ངན-སོང-གི-འཇིགས-པ	fear of unhappy rebirth\nSanskrit: durgati-bhayam\nPali: duggati-bhayam
འཁོར-གྱི-ནང-དུ-བག-ཚ-པའི-འཇིགས-པ	fear of bad reputation\nSanskrit: parṣad-āsādya-bhayam\nPali: parisā-āsajja-bhayam
སྒྲིབ-པ-གཉིས	two obscurations, veils, hindrances\nSanskrit: dve āvaraṇe\nPali: dve āvaraṇāni
ཉོན-མོངས-པའི-སྒྲིབ-པ	kilesāvaraṇam\nSanskrit: kleśāvaraṇam
ཤེས-བྱའི-སྒྲིབ-པ	intellectual obscuration\nSanskrit: jсeyāvaraṇam\nPali: сeyāvaraṇam
ཏིང-ངེ-རྫིན-གྱི-སྒྲིབ-པ-དྲུག	six hindrances for meditative absorption\nSanskrit: ṣaṭ samādhy-āvaraṇāni\nPali: cha samādhi-āvaraṇāni
གྱོ	pretending, dissimulation\nSanskrit: śāṭhyam\nPali: sāṭheyyam
རྩོལ-བ-མེད-པ	effortless\nSanskrit: anābhogaḥ\nPali: anābhogo
རྩོལ-བ	effortful\nSanskrit: sābhogaḥ\nPali: sābhogo
རྣམ-པར-རྟོག-པ-རྣམ-པ-གསུམ	construction of (false) ideas is threefold.\nSanskrit: vikalpas trividhaḥ\nPali: vikappo tividho
རྗེས-སུ-དྲན-པའི-རྟོག-པ	(false) ideas with respect to remembering.\nSanskrit: anusmaraṇa-vikalpaḥ\nPali: anussaraṇa-vikappo
ངེས-པར-རྟོག-པ	(false) ideas with respect to judgments.\nSanskrit: saṃtīraṇa-vikalpaḥ\nPali: saṃtīraṇa-vikappo
ལྷན-སྐྱེས-ཀྱི-རྟོག-པ	spontaneous (false) ideas (coming from inside)\nSanskrit: sahaja-vikalpaḥ\nPali: sahaja-vikappo
ས-བཅུ	ten stages (of Bodhisattvas)\nSanskrit: daśa bhūmayaḥ (f, sg bhūmi)\nPali: dasa bhūmayo
རབ-ཏུ-དགའི-ས	very joyful stage\nSanskrit: pramuditā bhūmiḥ
དྲི-མ-མེད-པའི-བྷུམི	immaculate stage\nSanskrit: vimalā bhūmiḥ
ཨོད-བྱེད-པའི-ས	brilliant stage\nSanskrit: prabhākarī bhūmiḥ
ཨོད-འཕྲོ-བའི-ས	radiant stage\nSanskrit: arciṣmatī bhūmiḥ
ཤིན-ཏུ-སྦྱང-དཀའ-བའི-ས	stage which ist very difficult to overcome (to reach)\nSanskrit: sudurjayā bhūmiḥ
མངོན-དུ-ཕྱོགས-པའི-ས	stage directed to go forward (towards wisdom)\nSanskrit: abhimukhī bhūmiḥ
རིང-དུ-སོང-བའི-ས	far reaching stage\nSanskrit: dūraṃgamā bhūmīḥ
མི-གཡོ-བའི-ས	immovable stage\nSanskrit: acalā bhūmiḥ
ལེགས-པའི-བློ-གྲོས-པའི-ས	stage well-established with faith and wisdom\nSanskrit: sādhumatī bhūmiḥ
ཆོས-ཀྱི-སྤྲིན-པའི-ས	stage (endowed with) clouds of the teachings\nSanskrit: dharma-meghā bhūmiḥ
ས-བཅུ-གསུམ	thirteen stages (of the Bodhisattvas) (the aforesaid ten with additional three:)\nSanskrit: trayodaśa bhūmayaḥ
ཀུན-དུ-ཨོད-པའི-ས	all around clearly radiating stage\nSanskrit: samantaprabhā bhūmiḥ
དཔེ-མེད-པའི-ས	incomparable stage\nSanskrit: nirupamā bhūmiḥ
ཡེ-ཤེས-ལྡན-པའི-ས	stage endowed with primordial wisdom\nSanskrit: jсānavatī bhūmiḥ
ཕ-རོལ-ཏུ-ཕྱིན-པ-དྲུག	six pefections, virtues\nSanskrit: ṣaṭ pāramitāḥ\nPali: saḷ pāramitā
སྦྱིན-པའི-ཕ-རོལ-ཏུ-ཕྱིན-པ	perfection of giving, generosity\nSanskrit: dāna-pāramitā\nPali: dāna-pāramitā
ཚུལ-ཁྲིམས-ཀྱི-ཕ-རོལ-ཏུ-ཕྱིན-པ	perfection of discipline, ethical behaviour\nSanskrit: śīla-pāramitā\nPali: sīla- pāramitā
བཟོད-པའི-ཕ-རོལ-ཏུ-ཕྱིན-པ	perfection of patience, acceptance\nSanskrit: kṣānti- pāramitā\nPali: khānti-pāramitā
བརྩོན-འགྲུས-ཀྱི-ཕ-རོལ-ཏུ-ཕྱིན-པ	perfection of energy, of enthusiastic persevearance, of joyful effort, of joyful heroism\nSanskrit: vīrya-pāramitā\nPali: viriya-pāramitā
བསམ-གཏན-གྱི-ཕ-རོལ-ཏུ-ཕྱིན-པ	perfection of meditative absorption\nSanskrit: dhyāna-pāramitā\nPali: jhāna-pāramitā
ཤེས-རབ-ཀྱི-ཕ-རོལ-ཏུ-ཕྱིན-པ	perfection of wisdom, of understanding.\nSanskrit: prajсā-pāramitā\nPali: paссā-pāramitā
ཕ-རོལ-ཏུ-ཕྱིན-པ-བཅུ	ten perfections (the aforesaid six and four additional ones:)\nSanskrit: daśa pāramitāḥ\nPali: dasa pāramitā
ཐབས-གྱི-ཕ-རོལ-ཏུ-ཕྱིན-པ	perfection of method, of skilful means\nSanskrit: upāya-pāramitā\nPali: upāya-pāramitā
སྨོན-ལམ-གྱི-ཕ-རོལ-ཏུ-ཕྱིན-པ	perfection of resolution\nSanskrit: praṇidhi-pāramitā\nPali: paṇidhi-pāramitā
སྟོབས-ཀྱི-ཕ-རོལ-ཏུ-ཕྱིན-པ	perfection of power\nSanskrit: bala-pāramitā\nPali: bala-pāramitā
ཡེ-ཤེས-ཀྱི-ཕ-རོལ-ཏུ-ཕྱིན-པ	perfection of primordial wisdom\nSanskrit: jсāna-pāramitā\nPali: сāna-pāramitā
སྦྱིན-པ-རྣམ-པ-གསུམ	giving is threefold\nSanskrit: dānam trividham\nPali: dānam tividham
ཆོས-ཀྱི-སྦྱིན-པ	giving of teachings (of dharma)\nSanskrit: dharma-dānam\nPali: dhamma-dānam
ཟང-ཟིང-གི-སྦྱིན-པ	material giving\nSanskrit: āmiṣa-dānam\nPali: āmisa-dānam
བྱམས-པའི-སྦྱིན-པ	giving of friendliness\nSanskrit: maitrī-dānam\nPali: mettā-dānam
ཚུལ-ཁྲིམས-རྣམ-པ-གསུམ	discipline is threefold, ethical behaviour\nSanskrit: śīlaṃ trividham\nPali: sīlam tividham
སྡོམ-པའི-ཚུལ-ཁྲིམས	discipline of restraint, related to ethical discipline and vows\nSanskrit: saṃvara- śīlam\nPali: saṃvara-sīlam
དགེ-བ-ཆོས-བསྡུད-ཀྱི-ཚུལ-ཁྲིམས	discipline of collecting the wholesome\nSanskrit: kuśala-saṅgrāha-śīlam\nPali: kusala-saṅgāha-sīlam
སེམས-ཅན-དོན-བྱེད-ཀྱི-ཚུལ-ཁྲིམས	discipline of doing what is benefitting sentient beings\nSanskrit: sattvārtha-kriyā-śīlam\nPali: sattattha-kiriya-sīlam
བཟོད-པ-རྣམ-པ-གསུམ	patience or acceptance is threefold\nSanskrit: kṣāntis trividhā\nPali: khānti tividhā
ཆོས-ལ-ངེས-པར-སེམས-པའི-བཟོད-པ	patience when understanding the teachings\nSanskrit: dharma-nidhyāna-kṣāntiḥ\nPali: dhamma-nijjhāna-khānti
སྡུག-བསྔལ-ལ-ཇི-མི-སྙམ-པའི-བཟོད-པ	patience when enduring suffering\nSanskrit: duḥkhādhivāsanā-kṣāntiḥ\nPali: dukkhādhivāsana-khānti
གཞན-ཕན-གྱི-ཆོས-ལ-བཟོད-པ	patience when others are successful\nSanskrit: paropakāra-dharma-kṣāntiḥ\nPali: paropakāra-khānti
བརྩཧོན-འགྲུས-རྣམ-པ-གསུམ	energy is threefold\nSanskrit: vīryaṃ trividham\nPali: viriyaṃ tividham
གོ-ཆའི-བརྩོ-འགྲུས	armourlike energy\nSanskrit: saṃnāha-vīryam\nPali: saṃnāha-viriyam
སྦྱོར-བའི-བརྩཧོན-འགྲུས	applied energy. energy for applying the appropriate methods.\nSanskrit: prayoga-vīryam\nPali: payoga-viriyam
ཡོངས-སུ-མཐར-ཐུག-པའི-བརྩཧོན-འགྲུས	unsatiable energy\nSanskrit: pariniṣṭhā-vīryam\nPali: pariniṭṭhā-viriyam
བསམ-གཏན-རྣམ-པ-གསུམ	meditative absorption is threefold\nSanskrit: dhyānaṃ trividham\nPali: jhānaṃ tividham
སྐྱོན-བཅས-ཐག-བསྲིང-བའི-བསམ-གཏན	meditative absorption connected with giving up hatred\nSanskrit: sa-doṣāpakarṣa-dhyānam\nPali: sa-dosa-apakassa-jhānam
བདེ-པར-གནས-པའི-བསམ-གཏན	meditative absorption connected with resting in joy\nSanskrit: sukha-vaihārika-dhyānam\nPali: sukha-vihārika-jhānam
མ-ལུས-པ-བརྒྱན-པའི-བསམ-གཏན	meditative absorption adorned with completion\nSanskrit: aśeṣa-vaibhūṣita-dhyānam\nPali: asesa-vibhusita-jhānam
ཤེས-རབ-རྣམ-པ-གསུམ	wisdom, understanding is threefold, three prajnas, three kinds of wisdom\nSanskrit: prajсā trividhā\nPali: paссā tividhā
ཐོས-པ-ལས-བྱུང-བའི-ཤེས-རབ	wisdom based on hearing, wisdom through hearing.\nSanskrit: śruta-mayī-prajсā\nPali: suta-mayī-paссā
བསམ-པ-ལས-བྱུང-བའི-ཤེས-རབ	wisdom based on contemplation, wisdom through contemplative analysis.\nSanskrit: cintā-mayī prajсā\nPali: cintā-mayī paссā
བསྒོམ-པ-ལས-བྱུང-བའི-ཤེས-རབ	wisdom based on meditation\nSanskrit: bhāvanā-mayī prajсā\nPali: bhāvanā-mayī paссā
ཐབས-རྣམ-པ-གསུམ	method or skilfull means is threefold\nSanskrit: upāyas trividhaḥ\nPali: upāyo tividho
སེམས-ཅན-ཐམས-ཅད-ཁོང-དུ-ཆུད-པའི-ཐབས	method aiming at awakening all beings\nSanskrit: sarva-sattvāvabodhaka upāyaḥ\nPali: sabba-sattvāvabodhaka upāyo
སེམས-ཅན-གྱི-དོན-ཀུན-ཏུ-བསགམ-པའི-ཐབས	method aiming at benefitting all beings\nSanskrit: sattvārtha-bhāvaka upāyaḥ\nPali: sattāttha-bhāvaka upāyo
ཤིན-ཏུ-མྱུར-བའི-བདེ-བ-མངོན-པར-རྗོགས-པར-བྱང-ཆུབ-པའི-ཐབས	method aiming at complete awakening which consists of quickly attained joy\nSanskrit: kṣipra-sukhābhisambodhi upāyaḥ\nPali: khippa-sukhābhisambodhi upāyo
སྨོན-ལམ-རྣམ-པ-གསུམ	resolution is threefold\nSanskrit: praṇidhānaṃ (praṇidhi) trividham\nPali: paṇidhānaṃ tividham
ཡང-དག-པའི-གནས-ལ-རབ-ཏུ-སྦྱོར-བའི-སྨོན-ལམ	resolution aiming at the duration of a pleasant situation or state\nSanskrit: susthāna-prābandhikam praṇidhānaṃ\nPali: suṭṭhāna-pābandhikam paṇidhānaṃ
སེམས-ཅན-གྱི-དོན-ལ-རབ-ཏུ-སྦྱོར-བའི-སྨོན-ལམ	resolution aiming at the duration of the benefit of all beings\nSanskrit: sattvārtha-prābandhikam praṇidhānaṃ\nPali: sattattha-pābandhikam paṇidhānaṃ
བདེན-པ-གཉིས	two truths, two kinds of truth\nSanskrit: dve satye\nPali: dve saccāni
ཀུན-རྫོབ-བདེན-པ	conventional truth, superficial truth\nSanskrit: saṃ-vṛti-satyam\nPali: sammuti-saccam
དོན-དམ-བདེན-པ	highest truth, ultimate truth\nSanskrit: paramārtha-satyam\nPali: paramattha-saccam
བདག-མེད-གཉིས	non-self is twofold, selflessness is twofold\nSanskrit: nairātmyaṃ dvividham
ཆོས-ཀྱི-བདག-མེད	non-self of dharmas, of phenomena\nSanskrit: dharma-nairātmyam
གང-ཟག-གི-བདག-མེད	non-self of person, of the individual\nSanskrit: pudgala-nairātmyam
རྩཧོགས-གཉིས	collection is twofold\nSanskrit: saṃbhāro dvividhaḥ\nPali: sambhāro dvividho
བསོད-རྣམས-གྱི-རྩཧོགས	collection of merit, of the wholesome, of the positive.\nSanskrit: puṇya-sambhāraḥ\nPali: puṇya-sambhāro
ཡེ-ཤེས-ཀྱི-རྩཧོགས	collection of deep wisdom.\nSanskrit: jсāna-sambhāraḥ\nPali: сāna-sambhāro
མངོན-ཤེས-ལྔ	five higher kinds of wisdom\nSanskrit: paсca-abhijсāḥ\nPali: paсca abhiссā
ལྷའི-མིག	divine eye\nSanskrit: divya-cakṣu\nPali: dibba-cakkhu
ལྷའི-རྣ-བ	divine ear. hearing what is distant.\nSanskrit: divya-śrotram\nPali: dibba-sotam
གཞན-གྱི-སེམས-ཤེས-པ	knowing the mind (thoughts) of others\nSanskrit: para-citta-jсānam\nPali: parassa ceto-pariya-сānam
སྔོན-གྱི-གནས-རྗེས-སུ-དྲན-པ	remembering former lives\nSanskrit: pūrva-nivāsa-anusmṛtiḥ\nPali: pubbe nivāsa-anussati
རྫུ-འཕྲུལ	magical powers\nSanskrit: ṛddhiḥ\nPali: iddhi
རྣམ-པར-ཐར-པ-གསུམ	three kinds of liberation\nSanskrit: trayo vimokṣāḥ\nPali: tayo vimokkhā
སྟོང-པ-ཉིད	openness, emptiness, voidness\nSanskrit: śūnyatā\nPali: suссatā
མཚན-མ-མེད-པ	without images, concepts, non-conceptual, direct\nSanskrit: animittaḥ\nPali: animitto
སྨོན-པ-མེད-པ	without dependency (on what?)\nSanskrit: apraṇihitaḥ\nPali: appaṇihito
རྣམ-ཐར-བརྒྱད	eight kinds of liberation\nSanskrit: aṣṭau vimokṣāḥ
གཟུགས-ཅན-གཟུགས-ལ-ལྟ-བས-སྟོང-བ	who has form sees forms as empty (void, open)\nSanskrit: rūpī rūpāni paśyati śūnyam
ནང-གཟུགས-མེད-པར-འདུ-ཤེས-ཤིང་།-ཕྱི-རོལ-གྱི-གཟུགས-རྣམསླ-ལྟ-བས-སྟོང-བ	ho has seen the formless (non-form) in her/himself, sees the outer forms as void.\nSanskrit: adhyātmārūpa-saṃjсī bahirdhā-rūpāni paśyati śūnyam
ནམ-མཁའ-མཐའ-ཡས-ཀྱི-སྐྱེ-མཆེད-རྣམས-ལ-ལྟ-བས-སྟོང-བ	S/he sees the realm of limitless space as void.\nSanskrit: ākāśānantyāyatanam paśyati śūnyam
རྣམ-ཤེས-མཐའ-ཡས-ཀྱི-སྐྱེ-མཆེད-རྣམས-ལ-ལྟ-བས-སྟོང-བ	S/he sees the realm of limitless consciousness as void.\nSanskrit: vijсānānantyāyatanam paśyati śūnyam
ཅི-ཡང-མེད-ཀྱི-སྐྱེ-མཆེད-རྣམས-ལ-ལྟ-བས-སྟོང-བ	S/he sees the realm of nothingness as void.\nSanskrit: ākiсcanyāyatanam paśyati śūnyam
འདུ-ཤེས-མེད-འདུ-ཤེས-མེད-མིན-གྱི-སྐྱེ-མཆེད-རྣམས-ལ-ལྟ-བས-སྟོང-བ	S/he sees the realm of neither perception nor non-perception as void.\nSanskrit: naivasaṃjсānāsaṃjсāyatanam paśyati śūnyam
གེགས-སེལ-སྡུག-པ-ལ-ལྟ-བས-སྟོང-བ	The nice feeling to have eliminated all hindrances she/he sees as void.\nSanskrit: vighnāpahaśubham paśyati śūnyam
འདུ-ཤེས-དང-ཚོར-བ-འགོག-པ-ལ-ལྟ-བས-སྟོང-བ	The dissolution of perception and non-perception s/he sees as void.\nSanskrit: saṃjсā-vedayita-nirodham paśyati śūnyam
སྟོང-པ-ཉིད-ཉི-ཤུ	twenty (aspects of) emptiness.\nSanskrit: viṃśatiḥ śūnyatā
ནང-སྟོང-པ-ཉིད	emptiness of the internal of the five senses\nSanskrit: adhyātma-śūnyatā
ཕྱི-སྟོང-པ-ཉིད	emptiness of the external\nSanskrit: bahirdhā- śūnyatā
ཕྱི-ནང-སྟོང-པ-ཉིད	emptiness of the internal and external\nSanskrit: adhyātma-bahridhā- śūnyatā
སྟོང-པ-ཉིད-སྟོང-པ-ཉིད	emptiness of emptiness\nSanskrit: śūnyatā- śūnyatā
ཆེན-པོ-སྟོང-པ-ཉིད	great emptiness, limitless voidness\nSanskrit: mahā-śūnyatā
དོན-དམ-པ-སྟོང-པ-ཉིད	emptiness of nirvana; emptines of the ultimate, emptiness of what is the highest\nSanskrit: paramārtha-śūnyatā
འདུས-བྱས-སྟོང-པ-ཉིད	emptiness of products, voidness of what is made\nSanskrit: saṃskṛta-śūnyatā
འདུས-མ-བྱས-སྟོང-པ-ཉིད	emptiness of non-products, voidness of what is not made\nSanskrit: asaṃskṛta-śūnyatā
མཐའ-ལས-འདས-པའི-སྟོང-པ-ཉིད	ultimate emptiness\nSanskrit: atyanta-śūnyatā
ཐོག-མ-དང-མཐའ-མ-མེད-པའི-སྟོང-པ-ཉིད	voidness of that which is without beginning and end Which is emptiness of cyclic exisstence, of samsara\nSanskrit: anavarāgra-śūnyatā
དོར-བ-མེད-པའི-སྟོང-པ-ཉིད	emptiness of the indestructible\nSanskrit: anavakāra-śūnyatā
རང-བཞིན-སྟོང-པ-ཉིད	emptiness of nature\nSanskrit: prakṛti-śūnyatā
ཆོས-ཐམས-ཅད-སྟོང-པ-ཉིད	emptiness of all phenomena, voidness of all dharmas\nSanskrit: sarva-dharma-śūnyatā
མཚན-ཉིད-སྟོང-པ-ཉིད	emptiness of definitions, voiudness of marks or characteristics\nSanskrit: lakṣaṇa-śūnyatā
མཚན-ཉིད-མེད-པའི-སྟོང-པ-ཉིད	emptiness of the unapprehendable, voidness of what is without characteristics\nSanskrit: alakṣaṇa-śūnyatā
དངོས-པོ-སྟོང-པ-ཉིད	emptiness of things\nSanskrit: bhāva-śūnyatā
དངོས-པོ-མེད-པའི-སྟོང-པ-ཉིད	emptiness of non-things\nSanskrit: abhāva-śūnyatā
ངོ-བོ-ཉིད-སྟོང-པ-ཉིད	emptiness of self nature, of inherent existenz, voidness of own nature\nSanskrit: svabhāva-śūnyatā
དངོས-པོ-མེད-པའི-ངོ-བོ-ཉིད-སྟོང-པ-ཉིད	emptiness of the inherent existence of non-things.\nSanskrit: abhāva-svabhāva-śūnyatā
གཞན-གྱི-དངོས-པོ-སྟོང-པ-ཉིད	emptiness of becoming through something else\nSanskrit: para-bhāva-śūnyatā
ཡེ-ཤེས-ལྔ	five primordial kinds of deep wisdom\nSanskrit: paсca jсānāni\nPali: paсca сānāni
མེ-ལོང-ལྟ-བུའི-ཡེ-ཤེས	mirror-like wisdom\nSanskrit: ādarśa-jсānam\nPali: ādāsa-сānam
མཉམ-པ-ཉིད-ཀྱི-ཡེ-ཤེས	wisdom of equality\nSanskrit: samatā-jсānam\nPali: samatā-сānam
སོ-སོར-རྟོགས-པའི-ཡེ-ཤེས	wisdom of discrimination\nSanskrit: pratyavekṣaṇa-jсānam\nPali: paccavekkhana-сānam
བྱ-བ-གྲུབ-པའི-ཡེ-ཤེས	all-accomplishing wisdom, wisdom of skilful means\nSanskrit: kṛtyānuṣṭhāna-jсānam\nPali: kiccānuṭṭhāna-сānam
ཤིན-ཏུ-རྣམ-པར-དག-བ-ཆོས-དབྱིངས-ཡེ-ཤེས	wisdom knowing that the realm of the dharmas is completely pure\nSanskrit: su-viṣuddha-dharma-dhātu-jсānam\nPali: su-visuddha-dhamma-dhātu-сānam
འཇིག-རྟེན-གསུམ	three worlds\nSanskrit: trayo lokāḥ\nPali: tayo lokā
འདོད-འཇིག-རྟེན	sense realm, world of the senses\nSanskrit: kāma-lokaḥ\nPali: kāma-loko
གཟུགས-འཇིག-རྟེན	form realm, world of form\nSanskrit: rūpa-lokaḥ\nPali: rūpa-loko
གཟུགས-མེད-འཇིག-རྟེན	realm of non-form\nSanskrit: arūpa-lokaḥ\nPali: arūpa-loko
ཁམས-གསུམ	three realms\nSanskrit: trayo dhātavaḥ\nPali: tayo dhātavo
འདོད-ཁམས།-གཟུགས-ཁམས།-གཟུགས-མེད-ཁམས	sense realm, from ream, formless realm\nSanskrit: kāma-dhātuḥ, rūpa-dhātuḥ, arūpa-dhātuḥ\nPali: kāma-dhātu, rūpa-dhātu, arūpa-dhātu
ཁམས-བཞི	realms of the four elements, of the four elementary powers\nSanskrit: catvāro dhātavaḥ\nPali: cattāro dhātavo
ས།-ཆུ།-མི།-རླུང	Earth, water, glowing/fire, wind\nSanskrit: pṛthivī , āp (f pl), tejas  vāyu\nPali: paṭhavī, āpo, tejo , vāyo
ཁམས-དྲུག-༎-ནམ-མཁའ།-རྣམ-ཤེས	realms of the six elements, of six elementary powers.\nSanskrit: ṣaḍ dhātavaḥ; ākāśaḥ; vijсānam;\nPali: cha dhātavo = (plus) ākāso, viссānam
དེ-ཉིད	thatness.\nSanskrit: tattvam\nPali: tattam
དེ-བཞིན-ཉིད	suchness\nSanskrit: tathatā\nPali: tathatā , tathattam
བརྡོ	inbetween-stage\nSanskrit: antarā-bhava\nPali: antarā-bhava
རྗེས-སུ-དྲན-པ-དྲུག	six kinds of mindfulnes, six objects of mindfulness\nSanskrit: ṣaḍ anusmṛtayaḥ\nPali: cha anusatayo
སངས-རྒྱས-རྗེས-སུ-དྲན-པ-དྲུག	mindfulness of the buddha\nSanskrit: buddhānusmṛti .\nPali: buddhānusati
ཆོས-རྗེས-སུ-དྲན-པ-དྲུག	mindfulness of the dharma\nSanskrit: dharmānusmṛti .\nPali: dhammānusati
དགེ-འདུན-རྗེས-སུ-དྲན-པ-དྲུག	mindfulness of the sangha\nSanskrit: saṅghānusmṛti .\nPali: saṅghānusati
ཚུལ-ཁྲིམས-རྗེས-སུ-དྲན-པ-དྲུག	mindfulness of ethics or discipline\nSanskrit: śīlānusmṛti\nPali: sīlānusati
གཏོང-བ-རྗེས-སུ-དྲན-པ-དྲུག	mindfulness of letting go\nSanskrit: tyāgānusmṛti\nPali: cāgānusati
ལྷ-རྗེས-སུ-དྲན-པ-དྲུག	mindfulness of the devas\nSanskrit: devānusmṛti\nPali: devānusati
